{},,,,,,,,,,,,,,,,,,,,,,,,,,,,,,,,,,,,,,,,,,,,,,,,,,,,,,,,,,,,,,,,,,,
Item Number,Item Name,Buy,Sell,Inventory,Asset Acct,Income Acct,Expense/COS Acct,Description,Use Desc. On Invoice,Custom List 1,Custom List 2,Custom List 3,Custom Field 1,Custom Field 2,Custom Field 3,Primary Supplier,Supplier Item Number,Tax Code When Bought,Buy Unit Measure,No. Items/Buy Unit,Reorder Quantity,Minimum Level,Selling Price,Sell Unit Measure,Tax Code When Sold,Sell Price Inclusive,Sales Tax Calc. Method,No. Items/Sell Unit,Quantity Break 1,Quantity Break 2,Quantity Break 3,Quantity Break 4,Quantity Break 5,"Price Level A, Qty Break 1","Price Level B, Qty Break 1","Price Level C, Qty Break 1","Price Level D, Qty Break 1","Price Level E, Qty Break 1","Price Level F, Qty Break 1","Price Level A, Qty Break 2","Price Level B, Qty Break 2","Price Level C, Qty Break 2","Price Level D, Qty Break 2","Price Level E, Qty Break 2","Price Level F, Qty Break 2","Price Level A, Qty Break 3","Price Level B, Qty Break 3","Price Level C, Qty Break 3","Price Level D, Qty Break 3","Price Level E, Qty Break 3","Price Level F, Qty Break 3","Price Level A, Qty Break 4","Price Level B, Qty Break 4","Price Level C, Qty Break 4","Price Level D, Qty Break 4","Price Level E, Qty Break 4","Price Level F, Qty Break 4","Price Level A, Qty Break 5","Price Level B, Qty Break 5","Price Level C, Qty Break 5","Price Level D, Qty Break 5","Price Level E, Qty Break 5","Price Level F, Qty Break 5",Inactive Item,Standard Cost,Default Ship/Sell Location,Default Recvd/Auto Location
ZZZ0001,WanmaLab Pendulum,B,S,I,11201,43003,50001,,,,,,1,,,QM Systems Ltd,,N-T,1,1,0,1,"£10,550.00",1,GST,,0,1,0,0,0,0,0,10550,10000,10000,10000,10000,10000,0,0,0,0,0,0,0,0,0,0,0,0,0,0,0,0,0,0,0,0,0,0,0,0,Y,"£6,990.00",,
ZZZ319,Flat Bed Trolley,B,S,I,11201,43003,50001,,,,,,3,,,Bunnings Warehouse,,GST,1,1,0,3,£65.00,1,GST,,0,1,0,0,0,0,0,65,10000,10000,10000,10000,10000,0,0,0,0,0,0,0,0,0,0,0,0,0,0,0,0,0,0,0,0,0,0,0,0,Y,£46.00,,
ZZZ0003,Wessex Tortus 3,B,S,I,11201,43003,50001,,,,,,1,,,QM Systems Ltd,,N-T,1,1,0,1,"£9,950.00",1,GST,,0,1,0,0,0,0,0,9950,7115.5,7115.5,7115.5,7115.5,7115.5,0,0,0,0,0,0,0,0,0,0,0,0,0,0,0,0,0,0,0,0,0,0,0,0,Y,"£7,570.00",,
ZZZ104,Wessex Release Plunger Spring,B,S,I,11201,43003,50001,,,,,,2,,,Small Parts and Bearings,,GST,1,1,0,1,£2.00,1,GST,,0,1,0,0,0,0,0,2,2,2,2,2,2,0,0,0,0,0,0,0,0,0,0,0,0,0,0,0,0,0,0,0,0,0,0,0,0,Y,£1.50,,
ZZZ114,Pendulum Release Catch,B,S,I,11201,43003,50001,,,,,,1,,,QM Systems Ltd,,GST,1,1,0,1,£148.00,1,GST,,0,1,0,0,0,0,0,148,135,135,135,135,135,0,0,0,0,0,0,0,0,0,0,0,0,0,0,0,0,0,0,0,0,0,0,0,0,Y,£105.62,,
ZZZ136,Pendulum Locking Knob,B,S,I,11201,43003,50001,,,,,,1,,,QM Systems Ltd,,GST,1,1,0,1,£123.00,1,GST,,0,1,0,0,0,0,0,123,180,180,180,180,180,0,0,0,0,0,0,0,0,0,0,0,0,0,0,0,0,0,0,0,0,0,0,0,0,Y,£87.96,,
ZZZ105,Wessex Release Plunger,B,S,I,11201,43003,50001,,,,,,2,,,QM Systems Ltd,,GST,1,1,0,2,£61.00,1,GST,,0,1,0,0,0,0,0,61,55,55,55,55,55,0,0,0,0,0,0,0,0,0,0,0,0,0,0,0,0,0,0,0,0,0,0,0,0,Y,£42.93,,
ZZZ132,Pendulum Arm,B,S,I,11201,43003,50001,,,,,,2,,,QM Systems Ltd,,GST,1,1,0,2,£78.00,1,GST,,0,1,0,0,0,0,0,78,140,140,140,140,140,0,0,0,0,0,0,0,0,0,0,0,0,0,0,0,0,0,0,0,0,0,0,0,0,Y,£70.10,,
ZZZ133,Pointer Counter Balance,B,S,I,11201,43003,50001,,,,,,1,,,QM Systems Ltd,,GST,1,1,0,1,£245.00,1,GST,,0,1,0,0,0,0,0,245,120,120,120,120,120,0,0,0,0,0,0,0,0,0,0,0,0,0,0,0,0,0,0,0,0,0,0,0,0,Y,£106.10,,
ZZZ138,Pendulum Clamping Nut,B,S,I,11201,43003,50001,,,,,,1,,,QM Systems Ltd,,GST,1,1,0,1,£174.00,1,GST,,0,1,0,0,0,0,0,174,150,150,150,150,150,0,0,0,0,0,0,0,0,0,0,0,0,0,0,0,0,0,0,0,0,0,0,0,0,Y,£123.90,,
ZZZ100,Wessex Verification Tile Jig,B,S,I,11201,43003,50001,Wessex Verification Testing Jig,,,,,1,,,QM Systems Ltd,,N-T,1,1,0,1,£495.00,1,GST,,0,1,0,0,0,0,0,495,540,540,540,540,540,0,0,0,0,0,0,0,0,0,0,0,0,0,0,0,0,0,0,0,0,0,0,0,0,Y,£420.00,,
ZZZ2001,4S (96) Rubber Slider,B,S,I,11201,43003,50001,,,,,,20,,,Smithers MSE Limited,,N-T,1,1,0,20,£95.00,1,GST,,0,1,0,0,0,0,0,95,70,70,70,70,70,0,0,0,0,0,0,0,0,0,0,0,0,0,0,0,0,0,0,0,0,0,0,0,0,Y,£61.50,,
ZZZ2004,TRS Float Glass,B,S,I,11201,43003,50001,,,,,,2,,,Munro Instruments Limited,,GST,1,1,0,2,£185.00,1,GST,,0,1,0,0,0,0,0,185,10000,10000,10000,10000,10000,0,0,0,0,0,0,0,0,0,0,0,0,0,0,0,0,0,0,0,0,0,0,0,0,Y,£115.00,,
ZZZ0005,WessexPendulum Calibration Rig,B,S,I,11201,43003,50001,,,,,,,,,Laboratorio de Resbaladicidad SL,,GST,1,1,0,0,"£3,300.00",1,GST,,0,1,0,0,0,0,0,3300,4455.5,4455.5,4455.5,4455.5,4455.5,0,0,0,0,0,0,0,0,0,0,0,0,0,0,0,0,0,0,0,0,0,0,0,0,Y,"£2,585.00",,
ZZZ2005,Pavigres Tile,B,S,I,11201,43003,50001,,,,,,2,,,Munro Instruments Limited,,GST,1,1,0,2,£185.00,1,GST,,0,1,0,0,0,0,0,185,10000,10000,10000,10000,10000,0,0,0,0,0,0,0,0,0,0,0,0,0,0,0,0,0,0,0,0,0,0,0,0,Y,£155.00,,
ZZZ101,Wessex Slider Humpback Pin,B,S,I,11201,43003,50001,,,,,,3,,,Wynnum Bearings and Bolts,,GST,,1,0,3,£2.00,1,N-T,,0,1,0,0,0,0,0,2,2,2,2,2,2,0,0,0,0,0,0,0,0,0,0,0,0,0,0,0,0,0,0,0,0,0,0,0,0,Y,£0.44,,
ZZZ102,Wessex Slider Spring,B,S,I,11201,43003,50001,Wessex Pendulum Slider Spring,,,,,5,,,QM Systems Ltd,,N-T,1,1,0,5,£28.00,1,GST,,0,1,0,0,0,0,0,28,45,45,45,45,45,0,0,0,0,0,0,0,0,0,0,0,0,0,0,0,0,0,0,0,0,0,0,0,0,Y,£19.60,,
ZZZ103,Wessex Slider Washer,B,S,I,11201,43003,50001,,,,,,5,,,Bunnings Warehouse,,GST,1,1,0,5,£1.00,1,GST,,0,1,0,0,0,0,0,1,1.5,1.5,1.5,1.5,1.5,0,0,0,0,0,0,0,0,0,0,0,0,0,0,0,0,0,0,0,0,0,0,0,0,Y,£0.36,,
ZZZ2002,TRL (55) Rubber Slider,B,S,I,11201,43003,50001,,,,,,1,,,Smithers MSE Limited,,GST,,1,0,1,£95.00,1,GST,,0,1,0,0,0,0,0,95,70,70,70,70,70,0,0,0,0,0,0,0,0,0,0,0,0,0,0,0,0,0,0,0,0,0,0,0,0,Y,£61.50,,
ZZZ107,Socket Head Screw (M4x10mm SS),B,S,I,11201,43003,50001,,,,,,5,,,Wynnum Bearings and Bolts,,GST,1,1,0,5,£4.00,1,GST,,0,1,0,0,0,0,0,4,4,4,4,4,4,0,0,0,0,0,0,0,0,0,0,0,0,0,0,0,0,0,0,0,0,0,0,0,0,Y,£3.00,,
ZZZ108,Socket Head Screw (M4x5mm SS),B,S,I,11201,43003,50001,,,,,,5,,,Wynnum Bearings and Bolts,,GST,1,1,0,5,£4.00,1,GST,,0,1,0,0,0,0,0,4,4,4,4,4,4,0,0,0,0,0,0,0,0,0,0,0,0,0,0,0,0,0,0,0,0,0,0,0,0,Y,£3.00,,
ZZZ106,Wessex Bullseye Level,B,S,I,11201,43003,50001,,,,,,1,,,QM Systems Ltd,,GST,1,1,0,1,£46.00,1,GST,,0,1,0,0,0,0,0,46,40,40,40,40,40,0,0,0,0,0,0,0,0,0,0,0,0,0,0,0,0,0,0,0,0,0,0,0,0,Y,£43.90,,
ZZZ109,M5x10mm Socket Head Grub Screw,B,S,I,11201,43003,50001,,,,,,5,,,,,GST,1,1,0,5,£2.00,1,GST,,0,1,0,0,0,0,0,2,1.5,1.5,1.5,1.5,1.5,0,0,0,0,0,0,0,0,0,0,0,0,0,0,0,0,0,0,0,0,0,0,0,0,Y,£1.33,,
ZZZ110,Nylon Screw (M5x10mm),B,S,I,11201,43003,50001,,,,,,5,,,,,GST,1,1,0,5,£2.00,1,GST,,0,1,0,0,0,0,0,2,1.5,1.5,1.5,1.5,1.5,0,0,0,0,0,0,0,0,0,0,0,0,0,0,0,0,0,0,0,0,0,0,0,0,Y,£0.75,,
ZZZ113,Pendulum Pointer Tip (Small),B,S,I,11201,43003,50001,,,,,,10,,,Independent Slip Testing Services,,GST,1,1,0,10,£5.00,1,GST,,0,1,0,0,0,0,0,5,5,5,5,5,5,0,0,0,0,0,0,0,0,0,0,0,0,0,0,0,0,0,0,0,0,0,0,0,0,Y,£4.00,,
ZZZ111,Nylon Screw M6x25mm,B,S,I,11201,43003,50001,,,,,,5,,,Small Parts and Bearings,,GST,1,1,0,5,£1.50,1,GST,,0,1,0,0,0,0,0,1.5,1.5,1.5,1.5,1.5,1.5,0,0,0,0,0,0,0,0,0,0,0,0,0,0,0,0,0,0,0,0,0,0,0,0,Y,£17.00,,
ZZZ112,Pointer Tip (Large Gauge),B,S,I,11201,43003,50001,,,,,,5,,,QM Systems Ltd,,GST,1,1,0,5,£5.00,3,GST,,0,1,0,0,0,0,0,5,35,35,35,35,35,0,0,0,0,0,0,0,0,0,0,0,0,0,0,0,0,0,0,0,0,0,0,0,0,Y,£4.00,,
ZZZ2003,Slider Backing Plate,B,S,I,11201,43003,50001,,,,,,5,,,QM Systems Ltd,0,GST,1,1,0,5,£45.00,1,GST,,0,1,0,0,0,0,0,45,13.3,13.3,13.3,13.3,13.3,0,0,0,0,0,0,0,0,0,0,0,0,0,0,0,0,0,0,0,0,0,0,0,0,Y,£25.00,,
ZZZ226,Knurled Thumb Screw M4 25mm,B,S,I,11201,43003,50001,,,,,,5,,,Small Parts and Bearings,,GST,1,1,0,5,£10.00,1,GST,,0,1,0,0,0,0,0,10,1000,1000,1000,1000,1000,0,0,0,0,0,0,0,0,0,0,0,0,0,0,0,0,0,0,0,0,0,0,0,0,Y,£12.68,,
ZZZ116,Knurled Nut and Screw,B,S,I,11201,43003,50001,,,,,,5,,,QM Systems Ltd,,GST,1,1,0,5,£31.00,1,GST,,0,1,0,0,0,0,0,31,1000,1000,1000,1000,1000,0,0,0,0,0,0,0,0,0,0,0,0,0,0,0,0,0,0,0,0,0,0,0,0,Y,£22.10,,
ZZZ117,Nut M10x30mm,B,S,I,11201,43003,50001,Pendulum Nut (Zenith M10 Stainless Steel Hex Nut M10x30mm),,,,,5,,,Bunnings Warehouse,,GST,1,1,0,5,£1.00,1,GST,,0,1,0,0,0,0,0,1,1000,1000,1000,1000,1000,0,0,0,0,0,0,0,0,0,0,0,0,0,0,0,0,0,0,0,0,0,0,0,0,Y,£0.48,,
ZZZ125,Pendulum C Spanner,B,S,I,11201,43003,50001,,,,,,3,,,Supercheap Auto,,GST,1,1,0,3,£70.00,1,GST,,0,1,0,0,0,0,0,70,1000,1000,1000,1000,1000,0,0,0,0,0,0,0,0,0,0,0,0,0,0,0,0,0,0,0,0,0,0,0,0,Y,£49.99,,
ZZZ118,Flat Washer M10x20mm,B,S,I,11201,43003,50001,,,,,,5,,,Bunnings Warehouse,,GST,1,1,0,5,£2.00,1,GST,,0,1,0,0,0,0,0,2,1000,1000,1000,1000,1000,0,0,0,0,0,0,0,0,0,0,0,0,0,0,0,0,0,0,0,0,0,0,0,0,Y,£0.90,,
ZZZ119,Nylon Nut M6,B,S,I,11201,43003,50001,,,,,,5,,,QM Systems Ltd,,GST,1,1,0,5,£21.00,1,GST,,0,1,0,0,0,0,0,21,1000,1000,1000,1000,1000,0,0,0,0,0,0,0,0,0,0,0,0,0,0,0,0,0,0,0,0,0,0,0,0,Y,£16.71,,
ZZZ121,Levelling Feet Nylon Flange,B,S,I,11201,43003,50001,,,,,,1,,,Small Parts and Bearings,,GST,1,1,0,1,£56.00,1,GST,,0,1,0,0,0,0,0,56,1000,1000,1000,1000,1000,0,0,0,0,0,0,0,0,0,0,0,0,0,0,0,0,0,0,0,0,0,0,0,0,Y,£40.00,,
ZZZ122,Pendulum Felt Friction Ring,B,S,I,11201,43003,50001,,,,,,4,,,QM Systems Ltd,,N-T,1,1,0,4,£45.00,1,GST,,0,1,0,0,0,0,0,45,1000,1000,1000,1000,1000,0,0,0,0,0,0,0,0,0,0,0,0,0,0,0,0,0,0,0,0,0,0,0,0,Y,£131.95,,
ZZZ115,Pointer Adjustment Striker,B,S,I,11201,43003,50001,,,,,,1,,,QM Systems Ltd,,GST,1,1,0,1,£119.00,1,GST,,0,1,0,0,0,0,0,119,1000,1000,1000,1000,1000,0,0,0,0,0,0,0,0,0,0,0,0,0,0,0,0,0,0,0,0,0,0,0,0,Y,£84.57,,
ZZZ800,Calibration Microfibre Cloth,B,S,I,11201,43003,50001,Blue,,,,,3,,,QM Systems Ltd,,GST,,1,0,3,£6.00,1,GST,,0,1,0,0,0,0,0,6,1000,1000,1000,1000,1000,0,0,0,0,0,0,0,0,0,0,0,0,0,0,0,0,0,0,0,0,0,0,0,0,Y,£4.00,,
ZZZ134,Pendulum Levelling Feet,B,S,I,11201,43003,50001,,,,,,3,,,Flexliner Pty Ltd,,GST,1,1,0,3,£119.00,1,GST,,0,1,0,0,0,0,0,119,1000,1000,1000,1000,1000,0,0,0,0,0,0,0,0,0,0,0,0,0,0,0,0,0,0,0,0,0,0,0,0,Y,£84.82,,
ZZZ137,Pendulum Release Button,B,S,I,11201,43003,50001,,,,,,1,,,QM Systems Ltd,,GST,1,1,0,1,£111.00,1,GST,,0,1,0,0,0,0,0,111,1000,1000,1000,1000,1000,0,0,0,0,0,0,0,0,0,0,0,0,0,0,0,0,0,0,0,0,0,0,0,0,Y,£78.97,,
ZZZ131,Pendulum Pointer Arm (MK2),B,S,I,11201,43003,50001,,,,,,3,,,Small Parts and Bearings,,GST,,1,0,0,£16.00,1,GST,,0,1,0,0,0,0,0,16,1000,1000,1000,1000,1000,0,0,0,0,0,0,0,0,0,0,0,0,0,0,0,0,0,0,0,0,0,0,0,0,Y,£10.95,,
ZZZ130,Pendulum Pointer Arm (MK1),B,S,I,11201,43003,50001,Pendulum Pointer Arm (MK1) - For new Wessex Model Pendulum ,,,,,1,,,QM Systems Ltd,,N-T,1,1,0,1,£245.00,1,GST,,0,1,0,0,0,0,0,245,1000,1000,1000,1000,1000,0,0,0,0,0,0,0,0,0,0,0,0,0,0,0,0,0,0,0,0,0,0,0,0,Y,£131.95,,
ZZZ126,Pendulum Slider Lifting Arm,B,S,I,11201,43003,50001,,,,,,1,,,QM Systems Ltd,,GST,1,1,0,1,£349.00,1,GST,,0,1,0,0,0,0,0,349,1000,1000,1000,1000,1000,0,0,0,0,0,0,0,0,0,0,0,0,0,0,0,0,0,0,0,0,0,0,0,0,Y,£249.60,,
ZZZ230,Tortus 3 Battery Pack,B,S,I,11201,43003,50001,,,,,,2,,,QM Systems Ltd,,GST,,1,0,2,£0.00,1,GST,,0,1,0,0,0,0,0,0,1000,1000,1000,1000,1000,0,0,0,0,0,0,0,0,0,0,0,0,0,0,0,0,0,0,0,0,0,0,0,0,Y,£89.85,,
ZZZ501,Cal Plate (AU) - Pendulum ,B,S,I,11201,43003,50001,,,,,,10,,,Tork Signs,,GST,1,1,0,10,£15.00,1,GST,,0,1,0,0,0,0,0,15,1000,1000,1000,1000,1000,0,0,0,0,0,0,0,0,0,0,0,0,0,0,0,0,0,0,0,0,0,0,0,0,Y,£8.50,,
ZZZ128,Pendulum Slider Support Rod,B,S,I,11201,43003,50001,,,,,,1,,,QM Systems Ltd,,GST,1,1,0,1,£142.00,1,GST,,0,1,0,0,0,0,0,142,1000,1000,1000,1000,1000,0,0,0,0,0,0,0,0,0,0,0,0,0,0,0,0,0,0,0,0,0,0,0,0,Y,£88.00,,
ZZZ202,Tortus Slider Plunger,B,S,I,11201,43003,50001,,,,,,1,,,Small Parts and Bearings,,GST,,1,0,1,£15.00,1,GST,,0,1,0,0,0,0,0,15,1000,1000,1000,1000,1000,0,0,0,0,0,0,0,0,0,0,0,0,0,0,0,0,0,0,0,0,0,0,0,0,Y,£15.41,,
ZZZ203,Grub Screw M3x6mm,B,S,I,11201,43003,50001,,,,,,5,,,Small Parts and Bearings,,GST,,1,0,5,£10.00,1,GST,,0,1,0,0,0,0,0,10,1000,1000,1000,1000,1000,0,0,0,0,0,0,0,0,0,0,0,0,0,0,0,0,0,0,0,0,0,0,0,0,Y,£0.86,,
ZZZ204,Grub Screw M3x3mm,B,S,I,11201,43003,50001,,,,,,5,,,Small Parts and Bearings,,GST,,1,0,5,£9.00,1,GST,,0,1,0,0,0,0,0,9,1000,1000,1000,1000,1000,0,0,0,0,0,0,0,0,0,0,0,0,0,0,0,0,0,0,0,0,0,0,0,0,Y,£0.95,,
ZZZ205,Nyloc Nut M4,B,S,I,11201,43003,50001,,,,,,5,,,Small Parts and Bearings,,GST,,1,0,5,£3.00,1,GST,,0,1,0,0,0,0,0,3,1000,1000,1000,1000,1000,0,0,0,0,0,0,0,0,0,0,0,0,0,0,0,0,0,0,0,0,0,0,0,0,Y,£3.25,,
ZZZ206,Pan Head Screw M4x10mm,B,S,I,11201,43003,50001,,,,,,5,,,Small Parts and Bearings,,GST,1,1,0,5,£1.00,1,GST,,0,1,0,0,0,0,0,1,1000,1000,1000,1000,1000,0,0,0,0,0,0,0,0,0,0,0,0,0,0,0,0,0,0,0,0,0,0,0,0,Y,£0.95,,
ZZZ207,Pan Head Screw M3x8mm,B,S,I,11201,43003,50001,,,,,,5,,,Small Parts and Bearings,,GST,1,1,0,5,£1.00,1,GST,,0,1,0,0,0,0,0,1,1000,1000,1000,1000,1000,0,0,0,0,0,0,0,0,0,0,0,0,0,0,0,0,0,0,0,0,0,0,0,0,Y,£0.95,,
ZZZ1101,Munro Felt Friction Ring,B,S,I,11201,43003,50001,,,,,,2,,,Munro Instruments Limited,,GST,1,1,0,2,£20.00,1,GST,,0,1,0,0,0,0,0,20,1000,1000,1000,1000,1000,0,0,0,0,0,0,0,0,0,0,0,0,0,0,0,0,0,0,0,0,0,0,0,0,Y,£11.75,,
ZZZ1102,Munro Pendulum Bullseye Level,B,S,I,11201,43003,50001,,,,,,1,,,Munro Instruments Limited,,GST,1,1,0,1,£90.00,1,GST,,0,1,0,0,0,0,0,90,1000,1000,1000,1000,1000,0,0,0,0,0,0,0,0,0,0,0,0,0,0,0,0,0,0,0,0,0,0,0,0,Y,£64.30,,
ZZZ1121,Munro Pointer,B,S,I,11201,43003,50001,,,,,,1,,,Munro Instruments Limited,,GST,1,1,0,1,£73.00,1,GST,,0,1,0,0,0,0,0,73,1000,1000,1000,1000,1000,0,0,0,0,0,0,0,0,0,0,0,0,0,0,0,0,0,0,0,0,0,0,0,0,Y,£52.85,,
ZZZ227,Tortus Printer Spindle,B,S,I,11201,43003,50001,,,,,,1,,,QM Systems Ltd,,GST,,1,0,1,£40.00,1,GST,,0,1,0,0,0,0,0,40,1000,1000,1000,1000,1000,0,0,0,0,0,0,0,0,0,0,0,0,0,0,0,0,0,0,0,0,0,0,0,0,Y,£38.90,,
ZZZ239,Tortus Drive Motor,B,S,I,11201,43003,50001,,,,,,1,,,Rotalink Limited,,GST,1,1,0,1,£420.00,1,GST,,0,1,0,0,0,0,0,420,1000,1000,1000,1000,1000,0,0,0,0,0,0,0,0,0,0,0,0,0,0,0,0,0,0,0,0,0,0,0,0,Y,£218.54,,
ZZZ201,Tortus Load Cell,B,S,I,11201,43003,50001,,,,,,1,,,Fortburn Pty Ltd,,GST,1,1,0,1,"£1,367.00",1,GST,,0,1,0,0,0,0,0,1367,1000,1000,1000,1000,1000,0,0,0,0,0,0,0,0,0,0,0,0,0,0,0,0,0,0,0,0,0,0,0,0,Y,"£1,093.00",,
ZZZ212,Tortus Load Cell Bracket Screw,B,S,I,11201,43003,50001,,,,,,6,,,Small Parts and Bearings,,GST,1,1,0,0,£4.00,1,GST,,0,1,0,0,0,0,0,4,1000,1000,1000,1000,1000,0,0,0,0,0,0,0,0,0,0,0,0,0,0,0,0,0,0,0,0,0,0,0,0,Y,£3.00,,
ZZZ213,Tortus Slider Post,B,S,I,11201,43003,50001,,,,,,2,,,QM Systems Ltd,,GST,1,1,0,2,£59.85,1,GST,,0,1,0,0,0,0,0,59.85,1000,1000,1000,1000,1000,0,0,0,0,0,0,0,0,0,0,0,0,0,0,0,0,0,0,0,0,0,0,0,0,Y,£65.55,,
ZZZ214,Tortus Slider Foot,B,S,I,11201,43003,50001,,,,,,5,,,QM Systems Ltd,,GST,,1,0,5,£95.00,1,GST,,0,1,0,0,0,0,0,95,1000,1000,1000,1000,1000,0,0,0,0,0,0,0,0,0,0,0,0,0,0,0,0,0,0,0,0,0,0,0,0,Y,£68.39,,
ZZZ215,Tortus Linear Ball Bearings,B,S,I,11201,43003,50001,,,,,,1,,,Small Parts and Bearings,,GST,1,1,0,1,£50.00,1,GST,,0,1,0,0,0,0,0,50,1000,1000,1000,1000,1000,0,0,0,0,0,0,0,0,0,0,0,0,0,0,0,0,0,0,0,0,0,0,0,0,Y,£35.00,,
ZZZ228,Tortus USB Stick,B,S,I,11201,43003,50001,,,,,,4,,,QM Systems Ltd,,GST,,1,0,4,£56.00,1,GST,,0,1,0,0,0,0,0,56,1000,1000,1000,1000,1000,0,0,0,0,0,0,0,0,0,0,0,0,0,0,0,0,0,0,0,0,0,0,0,0,Y,£39.90,,
ZZZ238,Tortus 2 Printer,B,S,I,11201,43003,50001,,,,,,4,,,Current Components Incorporated,,GST,1,1,0,4,£120.00,1,GST,,0,1,0,0,0,0,0,120,1000,1000,1000,1000,1000,0,0,0,0,0,0,0,0,0,0,0,0,0,0,0,0,0,0,0,0,0,0,0,0,Y,£57.00,,
ZZZ209,Tortus Printer Bracket Screw,B,S,I,11201,43003,50001,,,,,,5,,,Wynnum Bearings and Bolts,,GST,1,1,0,5,£1.50,1,GST,,0,1,0,0,0,0,0,1.5,1000,1000,1000,1000,1000,0,0,0,0,0,0,0,0,0,0,0,0,0,0,0,0,0,0,0,0,0,0,0,0,Y,£1.50,,
ZZZ813,,,,I,11201,,,,,,,,2,,,,,,,,,2,,,,,,,0,0,0,0,0,0,0,0,0,0,0,0,0,0,0,0,0,0,0,0,0,0,0,0,0,0,0,0,0,0,0,0,0,0,0,Y,,,
ZZZ241,Tortus 3 Charge Unit,B,S,I,11201,43003,50001,,,,,,3,,,ebay,,GST,1,1,0,3,£130.00,1,GST,,0,1,0,0,0,0,0,130,1000,1000,1000,1000,1000,0,0,0,0,0,0,0,0,0,0,0,0,0,0,0,0,0,0,0,0,0,0,0,0,Y,£90.00,,
ZZZ225,Tortus 2 Optek IR Sensor,B,S,I,11201,43003,50001,,,,,,2,,,Element 14,,GST,1,1,0,2,£10.00,1,GST,,0,1,0,0,0,0,0,10,10000,10000,10000,10000,10000,0,0,0,0,0,0,0,0,0,0,0,0,0,0,0,0,0,0,0,0,0,0,0,0,Y,£2.20,,
ZZZ229,Tortus 3 USB Board,B,S,I,11201,43003,50001,,,,,,4,,,GHI Electronics,,GST,1,1,0,4,£65.00,1,GST,,0,1,0,0,0,0,0,65,10000,10000,10000,10000,10000,0,0,0,0,0,0,0,0,0,0,0,0,0,0,0,0,0,0,0,0,0,0,0,0,Y,£178.57,,
ZZZ218,Tortus Control Buttons,B,S,I,11201,43003,50001,,,,,,5,,,JayCar Electronics,,GST,1,1,0,5,£5.00,1,GST,,0,1,0,0,0,0,0,5,1000,1000,1000,1000,1000,0,0,0,0,0,0,0,0,0,0,0,0,0,0,0,0,0,0,0,0,0,0,0,0,Y,£1.45,,
ZZZ243,Tortus Paper Rolls,B,S,I,11201,43003,50001,,,,,,10,,,Alliance Paper Products,,GST,1,1,0,10,£6.00,1,GST,,0,1,0,0,0,0,0,6,1000,1000,1000,1000,1000,0,0,0,0,0,0,0,0,0,0,0,0,0,0,0,0,0,0,0,0,0,0,0,0,Y,£4.00,,
ZZZ242,Tortus Carry Bag,B,S,I,11201,43003,50001,,,,,,0,,,Hiro Industrial Sewing Services,,GST,1,1,0,0,£400.00,1,GST,,0,1,0,0,0,0,0,400,1000,1000,1000,1000,1000,0,0,0,0,0,0,0,0,0,0,0,0,0,0,0,0,0,0,0,0,0,0,0,0,Y,£300.00,,
ZZZ223,Tortus Fuse 2.5amp,B,S,I,11201,43003,50001,,,,,,2,,,Petrol Stations/ Austoshops,,GST,1,1,0,0,£5.00,1,GST,,0,1,0,0,0,0,0,5,1000,1000,1000,1000,1000,0,0,0,0,0,0,0,0,0,0,0,0,0,0,0,0,0,0,0,0,0,0,0,0,Y,£1.45,,
ZZZ224,Tortus Fuse 6.5amp,B,S,I,11201,43003,50001,,,,,,2,,,Petrol Stations/ Austoshops,,GST,1,1,0,0,£10.00,1,GST,,0,1,0,0,0,0,0,10,1000,1000,1000,1000,1000,0,0,0,0,0,0,0,0,0,0,0,0,0,0,0,0,0,0,0,0,0,0,0,0,Y,£0.40,,
ZZZ2006,3M Lapping Film (pack 10),B,S,I,11201,43003,50001,,,,,,200,,,R.S. Hughes,,N-T,1,1,0,200,£50.00,1,GST,,0,1,0,0,0,0,0,50,40,1000,1000,1000,1000,0,0,0,0,0,0,0,0,0,0,0,0,0,0,0,0,0,0,0,0,0,0,0,0,Y,£2.09,,
ZZZ2007,P400 Paper (Pack 10),B,S,I,11201,43003,50001,,,,,,50,,,Northern Abrasives & Tools,10023485,GST,,1,0,50,£20.00,,GST,,0,1,0,0,0,0,0,20,1000,1000,1000,1000,1000,0,0,0,0,0,0,0,0,0,0,0,0,0,0,0,0,0,0,0,0,0,0,0,0,Y,£1.06,,
ZZZ324,Conditioning Board Feet,B,S,I,11201,43003,50001,,,,,,12,,,Clark Rubber,,GST,1,1,0,12,£2.50,1,GST,,0,1,0,0,0,0,0,2.5,2.5,2.5,2.5,2.5,2.5,0,0,0,0,0,0,0,0,0,0,0,0,0,0,0,0,0,0,0,0,0,0,0,0,Y,£1.40,,
ZZZ325,Conditioning Board Plates,B,S,I,11201,43003,50001,,,,,,3,,,Action Aluminium QLD Pty Ltd,,GST,1,1,0,3,£60.00,1,GST,,0,1,0,0,0,0,0,60,60,60,60,60,60,0,0,0,0,0,0,0,0,0,0,0,0,0,0,0,0,0,0,0,0,0,0,0,0,Y,£10.00,,
ZZZ326,Dry Control Testing BoardPlate,B,S,I,11201,43003,50001,,,,,,1,,,Action Aluminium QLD Pty Ltd,,GST,1,1,0,1,£19.80,1,GST,,0,1,0,0,0,0,0,19.8,120,120,120,120,120,0,0,0,0,0,0,0,0,0,0,0,0,0,0,0,0,0,0,0,0,0,0,0,0,Y,£20.00,,
ZZZ304,Digital Site Thermometer,B,S,I,11201,43003,50001,,,,,,5,,,ebay,,GST,1,1,0,5,£30.00,1,GST,,0,1,0,0,0,0,0,30,30,30,30,30,30,0,0,0,0,0,0,0,0,0,0,0,0,0,0,0,0,0,0,0,0,0,0,0,0,Y,£10.35,,
ZZZ307,Digital Site Level,B,S,I,11201,43003,50001,,,,,,3,,,Get Tools Direct,,GST,1,1,0,3,£185.00,1,GST,,0,1,0,0,0,0,0,185,140,140,140,140,140,0,0,0,0,0,0,0,0,0,0,0,0,0,0,0,0,0,0,0,0,0,0,0,0,Y,£144.54,,
ZZZ306,Spray Bottle,B,S,I,11201,43003,50001,,,,,,6,,,Bunnings Warehouse,,GST,1,1,0,6,£5.00,1,GST,,0,1,0,0,0,0,0,5,10,10,10,10,10,0,0,0,0,0,0,0,0,0,0,0,0,0,0,0,0,0,0,0,0,0,0,0,0,Y,£3.20,,
ZZZ313,Wet Floor Sign,B,S,I,11201,43003,50001,,,,,,3,,,Bunnings Warehouse,,GST,1,1,0,3,£20.00,1,GST,,0,1,0,0,0,0,0,20,20,20,20,20,20,0,0,0,0,0,0,0,0,0,0,0,0,0,0,0,0,0,0,0,0,0,0,0,0,Y,£7.60,,
ZZZ311,Blue Mop Head,B,S,I,11201,43003,50001,,,,,,3,,,Bunnings Warehouse,,GST,1,1,0,3,£22.00,1,GST,,0,1,0,0,0,0,0,22,30,30,30,30,30,0,0,0,0,0,0,0,0,0,0,0,0,0,0,0,0,0,0,0,0,0,0,0,0,Y,£17.41,,
ZZZ312,Telescopic Mop Handle,B,S,I,11201,43003,50001,,,,,,3,,,Bunnings Warehouse,,GST,1,1,0,3,£20.00,1,GST,,0,1,0,0,0,0,0,20,20,20,20,20,20,0,0,0,0,0,0,0,0,0,0,0,0,0,0,0,0,0,0,0,0,0,0,0,0,Y,£11.00,,
ZZZ301,Clipboard A4 (Dry),B,S,I,11201,43003,50001,,,,,,6,,,Office Works,,GST,1,1,0,6,£10.00,1,GST,,0,1,0,0,0,0,0,10,8,8,8,8,8,0,0,0,0,0,0,0,0,0,0,0,0,0,0,0,0,0,0,0,0,0,0,0,0,Y,£3.84,,
ZZZ302,Clipboard A4 (Wet),B,S,I,11201,43003,50001,,,,,,6,,,Office Works,,GST,1,1,0,6,£8.00,1,GST,,0,1,0,0,0,0,0,8,8,8,8,8,8,0,0,0,0,0,0,0,0,0,0,0,0,0,0,0,0,0,0,0,0,0,0,0,0,Y,£4.50,,
ZZZ303,Microfibre Dry Testing Cloth,B,S,I,11201,43003,50001,,,,,,12,,,Bunnings Warehouse,,GST,1,1,0,12,£12.00,1,GST,,0,1,0,0,0,0,0,12,12,12,12,12,12,0,0,0,0,0,0,0,0,0,0,0,0,0,0,0,0,0,0,0,0,0,0,0,0,Y,£8.50,,
ZZZ316,Step Testing Jack,B,S,I,11201,43003,50001,,,,,,5,,,Craig Lowrey,,GST,1,1,0,5,£100.00,1,GST,,0,1,0,0,0,0,0,100,50,50,50,50,50,0,0,0,0,0,0,0,0,0,0,0,0,0,0,0,0,0,0,0,0,0,0,0,0,Y,£70.00,,
ZZZ305,Testing Stool,B,S,I,11201,43003,50001,,,,,,4,,,Anaconda Group Pty Ltd,,GST,1,1,0,4,£35.00,1,GST,,0,1,0,0,0,0,0,35,35,35,35,35,35,0,0,0,0,0,0,0,0,0,0,0,0,0,0,0,0,0,0,0,0,0,0,0,0,Y,£19.99,,
ZZZ315,Traffic Cone,B,S,I,11201,43003,50001,,,,,,3,,,Bunnings Warehouse,,GST,1,1,0,3,£20.00,1,GST,,0,1,0,0,0,0,0,20,20,20,20,20,20,0,0,0,0,0,0,0,0,0,0,0,0,0,0,0,0,0,0,0,0,0,0,0,0,Y,£13.13,,
ZZZ314,Traffic Cone 'Keep Out' Collar,B,S,I,11201,43003,50001,,,,,,10,,,Adelaide Safety Supplies,,GST,1,1,0,10,£6.00,1,GST,,0,1,0,0,0,0,0,6,5,5,5,5,5,0,0,0,0,0,0,0,0,0,0,0,0,0,0,0,0,0,0,0,0,0,0,0,0,Y,£9.63,,
ZZZ809,Digital Inclinometer,B,S,I,11201,43003,50001,,,,,,1,,,Bunnings Warehouse,,GST,1,1,0,1,£63.00,1,GST,,0,1,0,0,0,0,0,63,25,25,25,25,25,0,0,0,0,0,0,0,0,0,0,0,0,0,0,0,0,0,0,0,0,0,0,0,0,Y,£45.00,,
ZZZ308,Doorstop,B,S,I,11201,43003,50001,,,,,,4,,,Bunnings Warehouse,,GST,1,1,0,4,£2.00,1,GST,,0,1,0,0,0,0,0,2,5,5,5,5,5,0,0,0,0,0,0,0,0,0,0,0,0,0,0,0,0,0,0,0,0,0,0,0,0,Y,£1.55,,
ZZZ502,Cal Temp Label - Pendulum,B,S,I,11201,43003,50001,,,,,,20,,,Tork Signs,,GST,1,1,0,20,£2.00,1,GST,,0,1,0,0,0,0,0,2,2,2,2,2,2,0,0,0,0,0,0,0,0,0,0,0,0,0,0,0,0,0,0,0,0,0,0,0,0,Y,£1.50,,
ZZZ504,Sticker - GPC Sample Label,B,S,I,11201,43003,50001,,,,,,50,,,Tork Signs,,GST,1,1,0,50,£3.50,1,GST,,0,1,0,0,0,0,0,3.5,3.5,3.5,3.5,3.5,3.5,0,0,0,0,0,0,0,0,0,0,0,0,0,0,0,0,0,0,0,0,0,0,0,0,Y,£2.50,,
ZZZ507,Sticker - General Equipment,B,S,I,11201,43003,50001,,,,,,50,,,Tork Signs,,GST,1,1,0,50,£2.00,1,GST,,0,1,0,0,0,0,0,2,2,2,2,2,2,0,0,0,0,0,0,0,0,0,0,0,0,0,0,0,0,0,0,0,0,0,0,0,0,Y,£1.50,,
ZZZ506,Sticker - Trolley Box,B,S,I,11201,43003,50001,,,,,,10,,,Tork Signs,,GST,1,1,0,10,£15.00,1,GST,,0,1,0,0,0,0,0,15,15,15,15,15,15,0,0,0,0,0,0,0,0,0,0,0,0,0,0,0,0,0,0,0,0,0,0,0,0,Y,£15.00,,
ZZZ803,Wet Floor Sign Sticker,B,S,I,11201,43003,50001,,,,,,10,,,Tork Signs,,GST,1,1,0,10,£15.00,1,GST,,0,1,0,0,0,0,0,15,15,15,15,15,15,0,0,0,0,0,0,0,0,0,0,0,0,0,0,0,0,0,0,0,0,0,0,0,0,Y,£8.00,,
ZZZ310,Trolley Storage Box,B,S,I,11201,43003,50001,,,,,,3,,,AE Works,,GST,1,1,0,3,£200.00,1,GST,,0,1,0,0,0,0,0,200,200,200,200,200,200,0,0,0,0,0,0,0,0,0,0,0,0,0,0,0,0,0,0,0,0,0,0,0,0,Y,£150.00,,
ZZZ320,Trolley Base Cups (Small),B,S,I,11201,43003,50001,,,,,,15,,,Bunnings Warehouse,,GST,1,1,0,15,£5.00,1,GST,,0,1,0,0,0,0,0,5,10000,10000,10000,10000,10000,0,0,0,0,0,0,0,0,0,0,0,0,0,0,0,0,0,0,0,0,0,0,0,0,Y,£1.40,,
ZZZ321,Trolley Base Cups (Large),B,S,I,11201,43003,50001,,,,,,15,,,Bunnings Warehouse,,GST,1,1,0,15,£5.00,1,GST,,0,1,0,0,0,0,0,5,10000,10000,10000,10000,10000,0,0,0,0,0,0,0,0,0,0,0,0,0,0,0,0,0,0,0,0,0,0,0,0,Y,£3.25,,
ZZZ322,Trolley Cup Bolt M8x40mm,B,S,I,11201,43003,50001,,,,,,15,,,Bunnings Warehouse,,GST,1,1,0,15,£1.00,1,GST,,0,1,0,0,0,0,0,1,10000,10000,10000,10000,10000,0,0,0,0,0,0,0,0,0,0,0,0,0,0,0,0,0,0,0,0,0,0,0,0,Y,£0.45,,
ZZZ323,Trolley Cup Lock Nut M8,B,S,I,11201,43003,50001,,,,,,15,,,Bunnings Warehouse,,GST,1,1,0,15,£3.00,1,GST,,0,1,0,0,0,0,0,3,10000,10000,10000,10000,10000,0,0,0,0,0,0,0,0,0,0,0,0,0,0,0,0,0,0,0,0,0,0,0,0,Y,£0.13,,
ZZZ327,Wet Ancillary Kit Hard Case,B,S,I,11201,43003,50001,,,,,,1,,,Luggage Direct,,GST,1,1,0,0,£550.00,1,GST,,0,1,0,0,0,0,0,550,10000,10000,10000,10000,10000,0,0,0,0,0,0,0,0,0,0,0,0,0,0,0,0,0,0,0,0,0,0,0,0,Y,£389.00,,
ZZZ318,Dry Ancillary Kit Strap,B,S,I,11201,43003,50001,,,,,,3,,,ebay,,GST,1,1,0,0,£15.00,1,GST,,0,1,0,0,0,0,0,15,10000,10000,10000,10000,10000,0,0,0,0,0,0,0,0,0,0,0,0,0,0,0,0,0,0,0,0,0,0,0,0,Y,£9.90,,
ZZZ807,Packaging Bag (Lapping),B,S,I,11201,43003,50001,,,,,,10,,,Office Works,,GST,1,1,0,10,£2.50,1,GST,,0,1,0,0,0,0,0,2.5,10000,10000,10000,10000,10000,0,0,0,0,0,0,0,0,0,0,0,0,0,0,0,0,0,0,0,0,0,0,0,0,Y,£1.60,,
ZZZ815,Packaging Bag (Slider),B,S,I,11201,43003,50001,,,,,,10,,,Office Works,,GST,1,1,0,10,£3.50,1,GST,,0,1,0,0,0,0,0,3.5,10000,10000,10000,10000,10000,0,0,0,0,0,0,0,0,0,0,0,0,0,0,0,0,0,0,0,0,0,0,0,0,Y,£2.50,,
ZZZ806,Packaging Bag (Post Pack),B,S,I,11201,43003,50001,,,,,,10,,,Post Shop,,GST,1,1,0,10,£4.00,1,GST,,0,1,0,0,0,0,0,4,10000,10000,10000,10000,10000,0,0,0,0,0,0,0,0,0,0,0,0,0,0,0,0,0,0,0,0,0,0,0,0,Y,£3.00,,
ZZZ328,Cotton Calibration Gloves,B,S,I,11201,43003,50001,,,,,,3,,,Office Works,,GST,1,1,0,3,£16.00,1,GST,,0,1,0,0,0,0,0,16,10000,10000,10000,10000,10000,0,0,0,0,0,0,0,0,0,0,0,0,0,0,0,0,0,0,0,0,0,0,0,0,Y,£11.18,,
ZZZ309,Digital Inclinometer,B,S,I,11201,43003,50001,,,,,,1,,,ebay,,GST,1,1,0,1,£65.00,1,GST,,0,1,0,0,0,0,0,65,10000,10000,10000,10000,10000,0,0,0,0,0,0,0,0,0,0,0,0,0,0,0,0,0,0,0,0,0,0,0,0,Y,£42.70,,
ZZZ211,Tortus 3 Charge Connector,B,S,I,11201,43003,50001,,,,,,3,,,JayCar Electronics,,GST,1,1,0,3,£5.00,1,GST,,0,1,0,0,0,0,0,5,10000,10000,10000,10000,10000,0,0,0,0,0,0,0,0,0,0,0,0,0,0,0,0,0,0,0,0,0,0,0,0,Y,£1.45,,
ZZZ701,Pendulum Trolley,B,S,I,11201,43003,50001,,,,,,3,,,Independent Slip Testing Services,,GST,1,1,0,3,£120.00,1,GST,,0,1,0,0,0,0,0,120,90,90,90,90,90,0,0,0,0,0,0,0,0,0,0,0,0,0,0,0,0,0,0,0,0,0,0,0,0,Y,£70.00,,
ZZZZ810,Calibration Temporary Label,B,S,I,11201,43003,50001,Calibration Temporary Label - Pendulum,,,,,5,,,Independent Slip Testing Services,,GST,1,1,0,5,£0.00,1,N-T,,0,1,0,0,0,0,0,0,67,67,67,67,67,0,0,0,0,0,0,0,0,0,0,0,0,0,0,0,0,0,0,0,0,0,0,0,0,Y,£1.00,,
ZZZ503,Cal Temp Label - Tortus,B,S,I,11201,43003,50001,Calibration Temporary Label - Tortus,,,,,1,,,Independent Slip Testing Services,,GST,1,1,0,1,£0.00,1,GST,,0,1,0,0,0,0,0,0,0,0,0,0,0,0,0,0,0,0,0,0,0,0,0,0,0,0,0,0,0,0,0,0,0,0,0,0,0,Y,£1.50,,
ZZZ804,Sticker - GPC Sample Label,B,S,I,11201,43003,50001,,,,,,1,,,Independent Slip Testing Services,,GST,1,1,0,1,£0.00,1,N-T,,0,1,0,0,0,0,0,0,0,0,0,0,0,0,0,0,0,0,0,0,0,0,0,0,0,0,0,0,0,0,0,0,0,0,0,0,0,Y,£2.50,,
ZZZ505,Sticker - Wet Floor Sign,B,S,I,11201,43003,50001,,,,,,1,,,Independent Slip Testing Services,,GST,1,1,0,1,£20.00,1,GST,,0,1,0,0,0,0,0,20,1250,1250,1250,1250,1250,0,0,0,0,0,0,0,0,0,0,0,0,0,0,0,0,0,0,0,0,0,0,0,0,Y,£14.36,,
ZZZ210,Tortus Bag Zipper,B,S,I,11201,43003,50001,,,,,,2,,,ebay,,GST,1,1,0,2,£4.00,1,GST,,0,1,0,0,0,0,0,4,1250,1250,1250,1250,1250,0,0,0,0,0,0,0,0,0,0,0,0,0,0,0,0,0,0,0,0,0,0,0,0,Y,£1.65,,
ZZZ401,WD40 (275g),B,S,I,11201,43003,50001,,,,,,,,,Independent Slip Testing Services,,GST,1,1,0,3,£11.00,1,N-T,,0,1,0,0,0,0,0,11,11,11,11,11,11,0,0,0,0,0,0,0,0,0,0,0,0,0,0,0,0,0,0,0,0,0,0,0,0,Y,£7.45,,
ZZZ402,Mentholated Spirits (1 Liter),B,S,I,11201,43003,50001,,,,,,,,,Independent Slip Testing Services,,GST,1,1,0,3,£0.00,1,N-T,,0,1,0,0,0,0,0,0,0,0,0,0,0,0,0,0,0,0,0,0,0,0,0,0,0,0,0,0,0,0,0,0,0,0,0,0,0,Y,£3.70,,
ZZZ403,Turpentine (1 Litre),B,S,I,11201,43003,50001,,,,,,,,,Independent Slip Testing Services,,GST,1,1,0,3,£0.00,1,N-T,,0,1,0,0,0,0,0,0,0,0,0,0,0,0,0,0,0,0,0,0,0,0,0,0,0,0,0,0,0,0,0,0,0,0,0,0,0,Y,£7.70,,
ZZZ404,Black Spray Paint,B,S,I,11201,43003,50001,,,,,,,,,Independent Slip Testing Services,,GST,1,1,0,3,£0.00,1,N-T,,0,1,0,0,0,0,0,0,0,0,0,0,0,0,0,0,0,0,0,0,0,0,0,0,0,0,0,0,0,0,0,0,0,0,0,0,0,Y,£8.30,,
ZZZ139,Pendulum Case Bracket (Top),B,S,I,11201,43003,50001,,,,,,4,,,,,GST,1,1,0,4,£14.00,1,GST,,0,1,0,0,0,0,0,14,13.3,13.3,13.3,13.3,13.3,0,0,0,0,0,0,0,0,0,0,0,0,0,0,0,0,0,0,0,0,0,0,0,0,Y,£10.00,,
ZZZ140,Pendulum Case Bracket (Bottom),B,S,I,11201,43003,50001,,,,,,4,,,QM Systems Ltd,,GST,1,1,0,0,£14.00,1,GST,,0,1,0,0,0,0,0,14,13.3,13.3,13.3,13.3,13.3,0,0,0,0,0,0,0,0,0,0,0,0,0,0,0,0,0,0,0,0,0,0,0,0,Y,£10.00,,
ZZZ208,Tortus Foot M4 Ballspring Plun,B,S,I,11201,43003,50001,,,,,,5,,,,,GST,,1,0,5,£2.66,,GST,,0,1,0,0,0,0,0,2.66,2.66,2.66,2.66,2.66,2.66,0,0,0,0,0,0,0,0,0,0,0,0,0,0,0,0,0,0,0,0,0,0,0,0,Y,£2.20,,
ZZZ4001,Training - Pendulum (AS4663),,S,,,43003,,,,,,,,,,,,,,,,,"£1,995.00",1,GST,,0,1,0,0,0,0,0,1995,1995,1995,1995,1995,1995,0,0,0,0,0,0,0,0,0,0,0,0,0,0,0,0,0,0,0,0,0,0,0,0,Y,,,
ZZZ120,M4x6mm Socket Head Grub Screw,B,S,I,11201,43003,50001,,,,,,3,,,Wynnum Bearings and Bolts,,GST,1,1,0,3,£1.00,1,GST,,0,1,0,0,0,0,0,1,0.55,0.55,0.55,0.55,0.55,0,0,0,0,0,0,0,0,0,0,0,0,0,0,0,0,0,0,0,0,0,0,0,0,Y,£0.25,,
ZZZ124,Pendulum M6 Foot Block Bolts,B,S,I,11201,43003,50001,,,,,,3,,,Wynnum Bearings and Bolts,,GST,1,1,0,3,£1.00,1,GST,,0,1,0,0,0,0,0,1,40,40,40,40,40,0,0,0,0,0,0,0,0,0,0,0,0,0,0,0,0,0,0,0,0,0,0,0,0,Y,£0.47,,
ZZZ127,Pendulum Arm Spring Assembly,B,S,I,11201,43003,50001,,,,,,1,,,QM Systems Ltd,,GST,1,1,0,1,£174.00,1,GST,,0,1,0,0,0,0,0,174,0.65,0.65,0.65,0.65,0.65,0,0,0,0,0,0,0,0,0,0,0,0,0,0,0,0,0,0,0,0,0,0,0,0,Y,£124.10,,
ZZZ123,Arm Spring Tension Clip,B,S,I,11201,43003,50001,,,,,,1,,,QM Systems Ltd,,GST,1,1,0,1,£124.00,1,GST,,0,1,0,0,0,0,0,124,124,124,124,124,124,0,0,0,0,0,0,0,0,0,0,0,0,0,0,0,0,0,0,0,0,0,0,0,0,Y,£88.10,,
ZZZ129,Pendulum Foot Assembly Cover,B,S,I,11201,43003,50001,,,,,,1,,,QM Systems Ltd,,GST,1,1,0,1,£429.00,1,GST,,0,1,0,0,0,0,0,429,429,429,429,429,429,0,0,0,0,0,0,0,0,0,0,0,0,0,0,0,0,0,0,0,0,0,0,0,0,Y,£306.03,,
ZZZ135,Levelling Feet Screw Knob,B,S,I,11201,43003,50001,,,,,,,,,RS Components Pty Ltd,,GST,1,1,0,0,£34.00,1,GST,,0,1,0,0,0,0,0,34,14,14,14,14,14,0,0,0,0,0,0,0,0,0,0,0,0,0,0,0,0,0,0,0,0,0,0,0,0,Y,£23.73,,
ZZZ237,Tortus 2 Front Wheel Assembly,B,S,I,11201,43003,50001,,,,,,,,,Transfer Multisort Elektronic,,GST,1,1,0,0,£200.00,1,GST,,0,1,0,0,0,0,0,200,14,14,14,14,14,0,0,0,0,0,0,0,0,0,0,0,0,0,0,0,0,0,0,0,0,0,0,0,0,Y,£160.00,,
ZZZ236,Tortus 2 Wheel Screws,B,S,I,11201,43003,50001,,,,,,,,,Transfer Multisort Elektronic,,GST,1,1,0,0,£1.50,1,GST,,0,1,0,0,0,0,0,1.5,200,200,200,200,200,0,0,0,0,0,0,0,0,0,0,0,0,0,0,0,0,0,0,0,0,0,0,0,0,Y,£0.90,,
ZZZ235,Tortus 2 Battery Door Screws,B,S,I,11201,43003,50001,,,,,,,,,Transfer Multisort Elektronic,,GST,1,1,0,0,£1.40,1,GST,,0,1,0,0,0,0,0,1.4,1.5,1.5,1.5,1.5,1.5,0,0,0,0,0,0,0,0,0,0,0,0,0,0,0,0,0,0,0,0,0,0,0,0,Y,£0.90,,
ZZZ234,Tortus 2 Case Fasteners,B,S,I,11201,43003,50001,,,,,,,,,Transfer Multisort Elektronic,,GST,1,1,0,0,£1.40,1,GST,,0,1,0,0,0,0,0,1.4,1.4,1.4,1.4,1.4,1.4,0,0,0,0,0,0,0,0,0,0,0,0,0,0,0,0,0,0,0,0,0,0,0,0,Y,£0.90,,
ZZZ233,Tortus 2 Printer Screws,B,S,I,11201,43003,50001,,,,,,,,,Transfer Multisort Elektronic,,GST,1,1,0,0,£1.40,1,GST,,0,1,0,0,0,0,0,1.4,1.4,1.4,1.4,1.4,1.4,0,0,0,0,0,0,0,0,0,0,0,0,0,0,0,0,0,0,0,0,0,0,0,0,Y,£0.90,,
ZZZ232,Tortus 2 Battery,B,S,I,11201,43003,50001,,,,,,,,,Transfer Multisort Elektronic,,GST,1,1,0,0,£120.00,1,GST,,0,1,0,0,0,0,0,120,1.4,1.4,1.4,1.4,1.4,0,0,0,0,0,0,0,0,0,0,0,0,0,0,0,0,0,0,0,0,0,0,0,0,Y,£106.10,,
ZZZ231,Tortus Power Buttons,B,S,I,11201,43003,50001,,,,,,,,,Transfer Multisort Elektronic,,GST,1,1,0,0,£36.00,1,GST,,0,1,0,0,0,0,0,36,1.4,1.4,1.4,1.4,1.4,0,0,0,0,0,0,0,0,0,0,0,0,0,0,0,0,0,0,0,0,0,0,0,0,Y,£46.10,,
ZZZ222,Tortus 2 Drive Motor Gears,B,S,I,11201,43003,50001,,,,,,,,,Transfer Multisort Elektronic,,GST,1,1,0,0,£125.00,1,GST,,0,1,0,0,0,0,0,125,36,36,36,36,36,0,0,0,0,0,0,0,0,0,0,0,0,0,0,0,0,0,0,0,0,0,0,0,0,Y,£111.10,,
ZZZ221,Tortus 2 Sensor Chip,B,S,I,11201,43003,50001,,,,,,,,,Transfer Multisort Elektronic,,GST,1,1,0,0,£25.00,1,GST,,0,1,0,0,0,0,0,25,125,125,125,125,125,0,0,0,0,0,0,0,0,0,0,0,0,0,0,0,0,0,0,0,0,0,0,0,0,Y,£36.10,,
ZZZ220,Tortus 2 Display Connector,B,S,I,11201,43003,50001,,,,,,,,,Transfer Multisort Elektronic,,GST,1,1,0,0,£25.00,1,GST,,0,1,0,0,0,0,0,25,25,25,25,25,25,0,0,0,0,0,0,0,0,0,0,0,0,0,0,0,0,0,0,0,0,0,0,0,0,Y,£36.10,,
ZZZ219,Tortus 2 Number Display Connec,B,S,I,11201,43003,50001,,,,,,,,,Transfer Multisort Elektronic,,GST,1,1,0,0,£25.00,1,GST,,0,1,0,0,0,0,0,25,25,25,25,25,25,0,0,0,0,0,0,0,0,0,0,0,0,0,0,0,0,0,0,0,0,0,0,0,0,Y,£36.10,,
ZZZ217,Tortus 2 Charge Connector,B,S,I,11201,43003,50001,,,,,,,,,Transfer Multisort Elektronic,,GST,1,1,0,0,£36.00,1,GST,,0,1,0,0,0,0,0,36,25,25,25,25,25,0,0,0,0,0,0,0,0,0,0,0,0,0,0,0,0,0,0,0,0,0,0,0,0,Y,£30.00,,
ZZZ216,Tortus 2 Rear Wheel,B,S,I,11201,43003,50001,,,,,,,,,Transfer Multisort Elektronic,,GST,1,1,0,0,£110.00,1,GST,,0,1,0,0,0,0,0,110,36,36,36,36,36,0,0,0,0,0,0,0,0,0,0,0,0,0,0,0,0,0,0,0,0,0,0,0,0,Y,£90.00,,
ZZZ4011,Training - Tortus (AS4663),,S,,,43003,,,,,,,,,,,,,,,,,£995.00,1,GST,,0,1,0,0,0,0,0,995,1995,1995,1995,1995,1995,0,0,0,0,0,0,0,0,0,0,0,0,0,0,0,0,0,0,0,0,0,0,0,0,Y,,,
ZZZ3001,Calibration- Pendulum,,S,,,43003,,,,,,,,,,,,,,,,,"£1,100.00",1,GST,,0,1,0,0,0,0,0,1100,995,995,995,995,995,0,0,0,0,0,0,0,0,0,0,0,0,0,0,0,0,0,0,0,0,0,0,0,0,Y,,,
ZZZ3004,Control Testing- Tortus,,S,,,43003,,,,,,,,,,,,,,,,,£500.00,1,GST,,0,1,0,0,0,0,0,500,1100,1100,1100,1100,1100,0,0,0,0,0,0,0,0,0,0,0,0,0,0,0,0,0,0,0,0,0,0,0,0,Y,,,
ZZZ3003,Control Testing- Pendulum,,S,,,43003,,,,,,,,,,,,,,,,,£500.00,1,GST,,0,1,0,0,0,0,0,500,500,500,500,500,500,0,0,0,0,0,0,0,0,0,0,0,0,0,0,0,0,0,0,0,0,0,0,0,0,Y,,,
ZZZ317,Calibration Microfibre Cloth,B,,I,11201,,,,,,,,,,,Tork Signs,,GST,1,1,0,50,,,,,,,0,0,0,0,0,0,0,0,0,0,0,0,0,0,0,0,0,0,0,0,0,0,0,0,0,0,0,0,0,0,0,0,0,0,0,Y,£16.00,,
ZZZ340,Safety - ISTS Hi-Viz vest,B,S,I,11201,43003,50001,,,,,,,,,QM Systems Ltd,,GST,1,1,0,5,£10.00,1,N-T,,0,1,0,0,0,0,0,10,10,10,10,10,10,0,0,0,0,0,0,0,0,0,0,0,0,0,0,0,0,0,0,0,0,0,0,0,0,Y,£6.95,,
ZZZ341,Safety - Hard Hat,B,S,I,11201,43003,50001,,,,,,,,,Tork Signs,,GST,1,1,0,50,£10.00,1,GST,,0,1,0,0,0,0,0,10,3.5,3.5,3.5,3.5,3.5,0,0,0,0,0,0,0,0,0,0,0,0,0,0,0,0,0,0,0,0,0,0,0,0,Y,£10.95,,
ZZZ3005,Equipment Repair- Labour charg,,S,,,43003,,,,,,,,,,,,,,,,,£130.00,1,GST,,0,1,0,0,0,0,0,130,130,130,130,130,130,0,0,0,0,0,0,0,0,0,0,0,0,0,0,0,0,0,0,0,0,0,0,0,0,Y,,,
ZZZ152,Pendulum M6x30mm Hex-Head Bolt,B,S,I,11201,43003,50001,,,,,,,,,Small Parts and Bearings,,GST,1,1,0,1,£3.00,1,GST,,0,1,0,0,0,0,0,3,40,40,40,40,40,0,0,0,0,0,0,0,0,0,0,0,0,0,0,0,0,0,0,0,0,0,0,0,0,Y,£1.77,,
ZZZ342,Safety - Gloves,B,S,I,11201,43003,50001,,,,,,,,,Blue Archive Box,,GST,1,1,0,1,£28.00,1,N-T,,0,1,0,0,0,0,0,28,0.66,0.66,0.66,0.66,0.66,0,0,0,0,0,0,0,0,0,0,0,0,0,0,0,0,0,0,0,0,0,0,0,0,Y,£19.98,,
ZZZ244,Tortus 3 Battery Connectors,B,S,I,11201,43003,50001,,,,,,6,,,Wessex Engineering,,GST,1,6,0,6,£5.00,1,GST,X,0,1,0,0,0,0,0,5,5,5,5,5,5,0,0,0,0,0,0,0,0,0,0,0,0,0,0,0,0,0,0,0,0,0,0,0,0,Y,£3.00,,
ZZZ145,Pendulum 6 BA Screws,B,S,I,11201,43003,50001,,,,,,5,,,Wynnum Bearings and Bolts,,GST,1,1,0,5,£1.00,1,GST,X,0,1,0,0,0,0,0,1,5,5,5,5,5,0,0,0,0,0,0,0,0,0,0,0,0,0,0,0,0,0,0,0,0,0,0,0,0,Y,£0.50,,
ZZZ343,Safety - Glasses,B,S,I,11201,43003,50001,,,,,,20,,,Tork Signs,,GST,1,1,0,20,£14.00,1,N-T,,0,1,0,0,0,0,0,14,2,2,2,2,2,0,0,0,0,0,0,0,0,0,0,0,0,0,0,0,0,0,0,0,0,0,0,0,0,Y,£9.98,,
ZZZ3002,Calibration- Tortus,,S,,,43003,,,,,,,,,,,,,,,,,£600.00,1,GST,,0,1,0,0,0,0,0,600,0,0,0,0,0,0,0,0,0,0,0,0,0,0,0,0,0,0,0,0,0,0,0,0,0,0,0,0,0,Y,,,
ZZZ1122,Munro Handle SA,B,S,I,11201,43003,50001,,,,,,,,,Munro Instruments Limited,,N-T,1,1,0,1,£115.70,1,GST,,0,1,0,0,0,0,0,115.7,0.66,0.66,0.66,0.66,0.66,0,0,0,0,0,0,0,0,0,0,0,0,0,0,0,0,0,0,0,0,0,0,0,0,Y,£82.66,,
ZZZ151,Slider Measuring Tool Backing ,B,S,I,11201,43003,50001,,,,,,,,,QM Systems Ltd,,GST,1,1,0,2,£39.00,1,GST,,0,1,0,0,0,0,0,39,140,140,140,140,140,0,0,0,0,0,0,0,0,0,0,0,0,0,0,0,0,0,0,0,0,0,0,0,0,Y,£0.00,,
ZZZ146,Pendulum Foot Bearing,B,S,I,11201,43003,50001,,,,,,,,,Wynnum Bearings and Bolts,,GST,1,1,0,5,£1.00,1,GST,X,0,1,0,0,0,0,0,1,1,1,1,1,1,0,0,0,0,0,0,0,0,0,0,0,0,0,0,0,0,0,0,0,0,0,0,0,0,Y,£0.00,,
ZZZ147,Pendulum Head Pivot,B,S,I,11201,43003,50001,,,,,,,,,QM Systems Ltd,,GST,1,1,0,5,£0.00,1,GST,X,0,1,0,0,0,0,0,0,1,1,1,1,1,0,0,0,0,0,0,0,0,0,0,0,0,0,0,0,0,0,0,0,0,0,0,0,0,Y,£0.00,,
ZZZ148,Pendulum High Friction Feet,B,S,I,11201,43003,50001,,,,,,,,,QM Systems Ltd,,GST,1,1,0,5,£100.00,1,GST,X,0,1,0,0,0,0,0,100,100,100,100,100,100,0,0,0,0,0,0,0,0,0,0,0,0,0,0,0,0,0,0,0,0,0,0,0,0,Y,£0.00,,
ZZZ149,Pendulum Knurled Nut (M5x30mm),B,S,I,11201,43003,50001,,,,,,,,,Small Parts and Bearings,,GST,1,1,0,5,£18.00,1,GST,X,0,1,0,0,0,0,0,18,18,18,18,18,18,0,0,0,0,0,0,0,0,0,0,0,0,0,0,0,0,0,0,0,0,0,0,0,0,Y,£12.68,,
ZZZ150,Pendulum Arm Attachment Clamp,B,S,I,11201,43003,50001,,,,,,,,,QM Systems Ltd,,GST,1,1,0,5,£50.00,1,GST,X,0,1,0,0,0,0,0,50,18,18,18,18,18,0,0,0,0,0,0,0,0,0,0,0,0,0,0,0,0,0,0,0,0,0,0,0,0,Y,£0.00,,
ZZZ2008,#60 Grit Paper,B,S,I,11201,43003,50001,,,,,,,,,Bunnings Warehouse,,GST,1,1,0,5,£2.00,1,GST,X,0,1,0,0,0,0,0,2,2,2,2,2,2,0,0,0,0,0,0,0,0,0,0,0,0,0,0,0,0,0,0,0,0,0,0,0,0,Y,£1.29,,
ZZZ814,Tortus Knurled Screw (M5x30mm),B,S,I,11201,43003,50001,,,,,,,,,Small Parts and Bearings,,GST,,1,0,4,£18.00,1,GST,,0,1,0,0,0,0,0,18,30,30,30,30,30,0,0,0,0,0,0,0,0,0,0,0,0,0,0,0,0,0,0,0,0,0,0,0,0,Y,£12.68,,
ZZZ329,Safety- Gear Bag,B,S,I,11201,43003,50001,,,,,,,,,ebay,,GST,1,1,0,1,£1.00,1,N-T,,0,1,0,0,0,0,0,1,65,65,65,65,65,0,0,0,0,0,0,0,0,0,0,0,0,0,0,0,0,0,0,0,0,0,0,0,0,Y,£15.98,,
ZZZ405,Brass Polish,B,S,I,11201,43003,50001,,,,,,,,,Independent Slip Testing Services,,GST,1,1,0,3,£0.00,1,N-T,,0,1,0,0,0,0,0,0,0,0,0,0,0,0,0,0,0,0,0,0,0,0,0,0,0,0,0,0,0,0,0,0,0,0,0,0,0,Y,£30.94,,
ZZZ406,Admin Archive Box,B,S,I,11201,43003,50001,,,,,,,,,Independent Slip Testing Services,,GST,1,1,0,3,£0.00,1,N-T,,0,1,0,0,0,0,0,0,0,0,0,0,0,0,0,0,0,0,0,0,0,0,0,0,0,0,0,0,0,0,0,0,0,0,0,0,0,Y,£10.00,,
ZZZ407,Super Glue - Powerflex Gel,B,S,I,11201,43003,50001,,,,,,,,,Independent Slip Testing Services,,GST,1,1,0,3,£14.00,1,N-T,,0,1,0,0,0,0,0,14,13,13,13,13,13,0,0,0,0,0,0,0,0,0,0,0,0,0,0,0,0,0,0,0,0,0,0,0,0,Y,£9.30,,
ZZZ408,Lock-Tite,B,S,I,11201,43003,50001,,,,,,,,,Independent Slip Testing Services,,GST,1,1,0,3,£0.00,1,N-T,,0,1,0,0,0,0,0,0,0,0,0,0,0,0,0,0,0,0,0,0,0,0,0,0,0,0,0,0,0,0,0,0,0,0,0,0,0,Y,£14.95,,
ZZZ409,Spray Glue,B,S,I,11201,43003,50001,,,,,,,,,Independent Slip Testing Services,,GST,1,1,0,3,£0.00,1,N-T,,0,1,0,0,0,0,0,0,0,0,0,0,0,0,0,0,0,0,0,0,0,0,0,0,0,0,0,0,0,0,0,0,0,0,0,0,0,Y,£20.99,,
ZZZ410,Packaging - Clear Wrap (roll),B,S,I,11201,43003,50001,,,,,,,,,Independent Slip Testing Services,,GST,1,1,0,3,£0.00,1,N-T,,0,1,0,0,0,0,0,0,0,0,0,0,0,0,0,0,0,0,0,0,0,0,0,0,0,0,0,0,0,0,0,0,0,0,0,0,0,Y,£19.99,,
ZZZ411,Packaging - Scotch Tape,B,S,I,11201,43003,50001,,,,,,,,,Independent Slip Testing Services,,GST,1,1,0,3,£9.00,1,N-T,,0,1,0,0,0,0,0,9,9,9,9,9,9,0,0,0,0,0,0,0,0,0,0,0,0,0,0,0,0,0,0,0,0,0,0,0,0,Y,£4.98,,
ZZZ412,Packaging - Large (A4),B,,I,11201,,,,,,,,,,,Independent Slip Testing Services,,GST,1,1,0,3,,,,,,,0,0,0,0,0,0,0,0,0,0,0,0,0,0,0,0,0,0,0,0,0,0,0,0,0,0,0,0,0,0,0,0,0,0,0,Y,£0.10,,
ZZZ413,Packaging - Medium Snaplock,B,,I,11201,,,,,,,,,,,Independent Slip Testing Services,,GST,1,1,0,3,,,,,,,0,0,0,0,0,0,0,0,0,0,0,0,0,0,0,0,0,0,0,0,0,0,0,0,0,0,0,0,0,0,0,0,0,0,0,Y,£0.10,,
ZZZ414,Packaging - Small Snaplock bag,B,,I,11201,,,,,,,,,,,Independent Slip Testing Services,,GST,1,1,0,3,,,,,,,0,0,0,0,0,0,0,0,0,0,0,0,0,0,0,0,0,0,0,0,0,0,0,0,0,0,0,0,0,0,0,0,0,0,0,Y,£0.10,,
ZZZ415,Packaging - Large Padded Satch,B,,I,11201,,,,,,,,,,,Independent Slip Testing Services,,GST,1,1,0,3,,,,,,,0,0,0,0,0,0,0,0,0,0,0,0,0,0,0,0,0,0,0,0,0,0,0,0,0,0,0,0,0,0,0,0,0,0,0,Y,£1.46,,
ZZZ416,Packaging - Small Padded Satch,B,,I,11201,,,,,,,,,,,Independent Slip Testing Services,,GST,1,1,0,3,,,,,,,0,0,0,0,0,0,0,0,0,0,0,0,0,0,0,0,0,0,0,0,0,0,0,0,0,0,0,0,0,0,0,0,0,0,0,Y,£0.46,,
ZZZ417,Microfibre Cleaning Cloths,B,,I,11201,,,Every pack has 20 clothes. ,,,,,,,,Independent Slip Testing Services,,GST,1,1,0,3,,,,,,,0,0,0,0,0,0,0,0,0,0,0,0,0,0,0,0,0,0,0,0,0,0,0,0,0,0,0,0,0,0,0,0,0,0,0,Y,£0.58,,
ZZZ418,Packaging - Cardboard (roll),B,,I,11201,,,,,,,,,,,Independent Slip Testing Services,,GST,1,1,0,3,,,,,,,0,0,0,0,0,0,0,0,0,0,0,0,0,0,0,0,0,0,0,0,0,0,0,0,0,0,0,0,0,0,0,0,0,0,0,Y,£54.95,,
ZZZ508,Sticker - GES (Small),B,,I,11201,,,,,,,,,,,Tork Signs,,GST,1,1,0,50,,,,,,,0,0,0,0,0,0,0,0,0,0,0,0,0,0,0,0,0,0,0,0,0,0,0,0,0,0,0,0,0,0,0,0,0,0,0,Y,£0.50,,
ZZZ702,Pendulum Conditioning Board,B,S,I,11201,43003,50001,,,,,,,,,Independent Slip Testing Services,,GST,1,1,0,5,£95.00,1,GST,,0,1,0,0,0,0,0,95,95,95,95,95,95,0,0,0,0,0,0,0,0,0,0,0,0,0,0,0,0,0,0,0,0,0,0,0,0,Y,£19.00,,
ZZZ703,Pendulum Onsite Testing Pack,B,S,I,11201,43003,50001,,,,,,,,,Independent Slip Testing Services,,GST,1,1,0,5,"£1,250.00",1,GST,,0,1,0,0,0,0,0,1250,1250,1250,1250,1250,1250,0,0,0,0,0,0,0,0,0,0,0,0,0,0,0,0,0,0,0,0,0,0,0,0,Y,£882.08,,
ZZZ704,Tortus Onsite Testing Pack,B,S,I,11201,43003,50001,,,,,,,,,Independent Slip Testing Services,,GST,1,1,0,5,£250.00,1,GST,,0,1,0,0,0,0,0,250,250,250,250,250,250,0,0,0,0,0,0,0,0,0,0,0,0,0,0,0,0,0,0,0,0,0,0,0,0,Y,£47.00,,
ZZZ705,Wessex P Verification Kit,B,S,I,11201,43003,50001,,,,,,,,,Independent Slip Testing Services,,GST,1,1,0,5,"£1,250.00",1,GST,,0,1,0,0,0,0,0,1250,1250,1250,1250,1250,1250,0,0,0,0,0,0,0,0,0,0,0,0,0,0,0,0,0,0,0,0,0,0,0,0,Y,£954.80,,
ZZZ706,Tortus Verification Kit,B,S,I,11201,43003,50001,,,,,,,,,Independent Slip Testing Services,,GST,1,1,0,1,£200.00,1,GST,,0,1,0,0,0,0,0,200,954,954,954,954,954,0,0,0,0,0,0,0,0,0,0,0,0,0,0,0,0,0,0,0,0,0,0,0,0,Y,£115.50,,
ZZZ707,ISTS Wet Floor Sign,B,S,I,11201,43003,50001,,,,,,,,,Independent Slip Testing Services,,GST,1,1,0,5,£0.00,1,GST,,0,1,0,0,0,0,0,0,200,200,200,200,200,0,0,0,0,0,0,0,0,0,0,0,0,0,0,0,0,0,0,0,0,0,0,0,0,Y,£0.00,,
601,ISTS Male Uniforms,B,,,,,61803,,,,,,,,,Riverland Marketing,,GST,1,,0,,,,,,,,0,0,0,0,0,0,0,0,0,0,0,0,0,0,0,0,0,0,0,0,0,0,0,0,0,0,0,0,0,0,0,0,0,0,0,N,£49.95,,
602,ISTS Female Uniforms,B,,,,,61803,,,,,,,,,Riverland Marketing,,GST,1,,0,,,,,,,,0,0,0,0,0,0,0,0,0,0,0,0,0,0,0,0,0,0,0,0,0,0,0,0,0,0,0,0,0,0,0,0,0,0,0,N,£45.00,,
603,ISTS Male Sweater,B,,,,,61803,,,,,,,,,Riverland Marketing,,GST,1,,0,,,,,,,,0,0,0,0,0,0,0,0,0,0,0,0,0,0,0,0,0,0,0,0,0,0,0,0,0,0,0,0,0,0,0,0,0,0,0,N,£62.00,,
604,ISTS Female Sweater,B,,,,,61803,,,,,,,,,Riverland Marketing,,GST,1,1,0,0,,,,,,,0,0,0,0,0,0,0,0,0,0,0,0,0,0,0,0,0,0,0,0,0,0,0,0,0,0,0,0,0,0,0,0,0,0,0,N,£62.00,,
605,ISTS Jacket,B,,,,,61803,,,,,,,,,Riverland Marketing,,GST,1,1,0,0,,,,,,,0,0,0,0,0,0,0,0,0,0,0,0,0,0,0,0,0,0,0,0,0,0,0,0,0,0,0,0,0,0,0,0,0,0,0,N,£81.00,,
ZZZ153,Pendulum Foot Cover Bracket,B,S,I,11201,43003,50001,Bracket sit on top of foot assembly,,,,,,,,,,GST,,1,0,0,£0.00,,GST,,0,1,0,0,0,0,0,0,0,0,0,0,0,0,0,0,0,0,0,0,0,0,0,0,0,0,0,0,0,0,0,0,0,0,0,0,0,Y,£18.00,,
ZZZ154,Pendulum Catch/ Release Block,B,S,I,11201,43003,50001,,,,,,,,,,,GST,,1,0,0,£0.00,,GST,,0,1,0,0,0,0,0,0,0,0,0,0,0,0,0,0,0,0,0,0,0,0,0,0,0,0,0,0,0,0,0,0,0,0,0,0,0,Y,£215.00,,
ZZZ155,Pendulum Handle Cover Bracket,B,S,I,11201,43003,50001,Pendulum carry handle screw bracket,,,,,,,,,,GST,,1,0,0,£0.00,,GST,,0,1,0,0,0,0,0,0,0,0,0,0,0,0,0,0,0,0,0,0,0,0,0,0,0,0,0,0,0,0,0,0,0,0,0,0,0,Y,£3.50,,
ZZZ1103,Munro Slider Spring,B,S,I,11201,43003,50001,,,,,,,,,,,GST,,1,0,0,£0.00,,GST,,0,1,0,0,0,0,0,0,0,0,0,0,0,0,0,0,0,0,0,0,0,0,0,0,0,0,0,0,0,0,0,0,0,0,0,0,0,Y,£18.50,,
ZZZ1104,Munro Slider Pin,B,S,I,11201,43003,50001,,,,,,,,,,,GST,,1,0,0,£0.00,,GST,,0,1,0,0,0,0,0,0,0,0,0,0,0,0,0,0,0,0,0,0,0,0,0,0,0,0,0,0,0,0,0,0,0,0,0,0,0,Y,£4.30,,
ZZZ1105,Munro Pointer Striker,B,S,I,11201,43003,50001,,,,,,,,,,,GST,,1,0,0,£0.00,,GST,,0,1,0,0,0,0,0,0,0,0,0,0,0,0,0,0,0,0,0,0,0,0,0,0,0,0,0,0,0,0,0,0,0,0,0,0,0,Y,£92.02,,
ZZZ1106,Munro Slider Washer,B,S,I,11201,43003,50001,,,,,,,,,,,GST,,1,0,0,£0.00,,GST,,0,1,0,0,0,0,0,0,0,0,0,0,0,0,0,0,0,0,0,0,0,0,0,0,0,0,0,0,0,0,0,0,0,0,0,0,0,Y,£4.30,,
ZZZ1107,Munro Nylon Screw,B,S,I,11201,43003,50001,Munro Pointer Striker adjustment,,,,,,,,,,N-T,,1,0,0,£0.00,,GST,,0,1,0,0,0,0,0,0,0,0,0,0,0,0,0,0,0,0,0,0,0,0,0,0,0,0,0,0,0,0,0,0,0,0,0,0,0,Y,£4.30,,
ZZZ1108,Munro Nylon Nut,B,S,I,11201,43003,50001,Munro Pointer Striker adjustment,,,,,,,,,,N-T,,1,0,0,£0.00,,GST,,0,1,0,0,0,0,0,0,0,0,0,0,0,0,0,0,0,0,0,0,0,0,0,0,0,0,0,0,0,0,0,0,0,0,0,0,0,Y,£4.30,,
ZZZ1125,Munro Spring Tension Assembly,B,S,I,11201,43003,50001,Munro Tension Rod Assembly,,,,,,,,,,GST,,1,0,0,£0.00,,GST,,0,1,0,0,0,0,0,0,0,0,0,0,0,0,0,0,0,0,0,0,0,0,0,0,0,0,0,0,0,0,0,0,0,0,0,0,0,Y,£206.56,,
ZZZ1109,Munro Tension Spring Assembly,B,S,I,11201,43003,50001,,,,,,,,,,,N-T,,1,0,0,£0.00,,GST,,0,1,0,0,0,0,0,0,0,0,0,0,0,0,0,0,0,0,0,0,0,0,0,0,0,0,0,0,0,0,0,0,0,0,0,0,0,Y,£53.36,,
ZZZ344,Stainless Steel Ruler 15cm,B,,I,11201,,,,,,,,,,,Tork Signs,,GST,1,1,0,20,,,,,,,0,0,0,0,0,0,0,0,0,0,0,0,0,0,0,0,0,0,0,0,0,0,0,0,0,0,0,0,0,0,0,0,0,0,0,Y,£2.58,,
ZZZ164,Pendulum Foot Post Bracket,B,S,I,11201,43003,50001,,,,,,,,,,,GST,,1,0,0,£140.00,,GST,,0,1,0,0,0,0,0,140,1.8,1.8,1.8,1.8,1.8,0,0,0,0,0,0,0,0,0,0,0,0,0,0,0,0,0,0,0,0,0,0,0,0,Y,£100.00,,
ZZZ1120,M5 X25 Socket Head Cap Screw,B,S,I,11201,43003,50001,,,,,,,,,Wynnum Bearings and Bolts,,GST,,1,0,0,£1.80,,GST,,0,1,0,0,0,0,0,1.8,140,140,140,140,140,0,0,0,0,0,0,0,0,0,0,0,0,0,0,0,0,0,0,0,0,0,0,0,0,Y,£0.36,,
ZZZ812,Trolley Cup Washer,B,S,I,11201,43003,50001,,,,,,,,,,,GST,1,1,0,0,£1.00,1,GST,,0,1,0,0,0,0,0,1,1,1,1,1,1,0,0,0,0,0,0,0,0,0,0,0,0,0,0,0,0,0,0,0,0,0,0,0,0,Y,£0.07,,
ZZZ345,Trolley Cup Washers,B,S,I,11201,43003,50001,,,,,,,,,Bunnings Warehouse,,GST,,1,0,0,£0.00,,GST,,0,1,0,0,0,0,0,0,0,0,0,0,0,0,0,0,0,0,0,0,0,0,0,0,0,0,0,0,0,0,0,0,0,0,0,0,0,Y,£0.00,,
ZZZ1126,Munro Wire Assembly,B,S,I,11201,43003,50001,,,,,,,,,,,N-T,,1,0,0,£0.00,,GST,,0,1,0,0,0,0,0,0,0,0,0,0,0,0,0,0,0,0,0,0,0,0,0,0,0,0,0,0,0,0,0,0,0,0,0,0,0,Y,£0.00,,
ZZZ1123,Munro Levelling Screw,B,S,I,11201,43003,50001,,,,,,,,,,,N-T,,1,0,0,£0.00,,GST,,0,1,0,0,0,0,0,0,0,0,0,0,0,0,0,0,0,0,0,0,0,0,0,0,0,0,0,0,0,0,0,0,0,0,0,0,0,Y,£0.00,,
ZZZ1124,Munro Pointer Stop Br,B,S,I,11201,43003,50001,,,,,,,,,,,N-T,,1,0,0,£0.00,,GST,,0,1,0,0,0,0,0,0,0,0,0,0,0,0,0,0,0,0,0,0,0,0,0,0,0,0,0,0,0,0,0,0,0,0,0,0,0,Y,£0.00,,
ZZZ1110,Munro Levelling 'Screw' Screw,B,S,I,11201,43003,50001,,,,,,,,,Smithers MSE Limited,,N-T,1,1,0,20,£1.00,1,GST,,0,1,0,0,0,0,0,1,95,95,95,95,95,0,0,0,0,0,0,0,0,0,0,0,0,0,0,0,0,0,0,0,0,0,0,0,0,Y,£0.50,,
ZZZ170,Pendulum Slider Rod Post,B,S,I,11201,43003,50001,,,,,,,,,,,N-T,,1,0,0,£0.00,,GST,,0,1,0,0,0,0,0,0,0,0,0,0,0,0,0,0,0,0,0,0,0,0,0,0,0,0,0,0,0,0,0,0,0,0,0,0,0,Y,£0.00,,
ZZZ1111,Pointer Bearing Sub Assembly,B,S,I,11201,43003,50001,,,,,,,,,,,N-T,,1,0,0,£250.00,,GST,,0,1,0,0,0,0,0,250,250,250,250,250,250,0,0,0,0,0,0,0,0,0,0,0,0,0,0,0,0,0,0,0,0,0,0,0,0,Y,£159.41,,
ZZZ1112,Munro Friction Ring Adjuster,B,S,I,11201,43003,50001,,,,,,,,,,,N-T,,1,0,0,£32.31,,GST,,0,1,0,0,0,0,0,32.31,250,250,250,250,250,0,0,0,0,0,0,0,0,0,0,0,0,0,0,0,0,0,0,0,0,0,0,0,0,Y,£23.08,,
ZZZ1113,Munro Screw 10BA,B,S,I,11201,43003,50001,,,,,,,,,,,N-T,,1,0,0,£2.17,,GST,,0,1,0,0,0,0,0,2.17,32.31,32.31,32.31,32.31,32.31,0,0,0,0,0,0,0,0,0,0,0,0,0,0,0,0,0,0,0,0,0,0,0,0,Y,£1.55,,
ZZZ0002,Wessex Pendulum (Used),B,S,I,11201,43003,50001,,,,,,,,,,,GST,,1,0,0,"£5,950.00",,GST,,0,1,0,0,0,0,0,5950,5500,5500,5500,5500,5500,0,0,0,0,0,0,0,0,0,0,0,0,0,0,0,0,0,0,0,0,0,0,0,0,Y,"£3,850.00",,
ZZZ1127,Munro Pendulum Tool Kit,B,S,I,11201,43003,50001,Tool Kit for Pendulum Tester \r\nStock: SX1704\r\n,,,,,,,,,,N-T,,1,0,0,£158.00,1,GST,,0,1,0,0,0,0,0,158,158,158,158,158,158,0,0,0,0,0,0,0,0,0,0,0,0,0,0,0,0,0,0,0,0,0,0,0,0,Y,£99.99,,
ZZZ1114,Munro 6BA x 5/32,B,S,I,11201,43003,50001,6BA X 5/32 CH/HD ST/ST\r\nSOTCK CODE: 101884A,,,,,,,,,,N-T,,1,0,0,£20.00,1,GST,,0,1,0,0,0,0,0,20,158,158,158,158,158,0,0,0,0,0,0,0,0,0,0,0,0,0,0,0,0,0,0,0,0,0,0,0,0,Y,£1.36,,
ZZZ1115,Munro 6BA X 1/4,B,S,I,11201,43003,50001,6BA X1/4 CH/HD ST/ST\r\nSTOCK CODE: 101884,,,,,,,,,,N-T,,1,0,0,£20.00,1,GST,,0,1,0,0,0,0,0,20,20,20,20,20,20,0,0,0,0,0,0,0,0,0,0,0,0,0,0,0,0,0,0,0,0,0,0,0,0,Y,£1.36,,
ZZZ1128,Munro Pendulum Loading Spring ,B,S,I,11201,43003,50001,Stock Code: 303172\r\n,,,,,,,,,,N-T,,1,0,0,£57.00,1,GST,,0,1,0,0,0,0,0,57,20,20,20,20,20,0,0,0,0,0,0,0,0,0,0,0,0,0,0,0,0,0,0,0,0,0,0,0,0,Y,£27.11,,
ZZZ1116,Munro Swinging Arm Adaptor,B,S,I,11201,43003,50001,"Stock Code: 303202, ",,,,,,,,,,N-T,,1,0,0,£20.00,1,GST,,0,1,0,0,0,0,0,20,57,57,57,57,57,0,0,0,0,0,0,0,0,0,0,0,0,0,0,0,0,0,0,0,0,0,0,0,0,Y,£1.09,,
ZZZ1117,Munro Pendulum Foot Weight ,B,S,I,11201,43003,50001,Stock Code: 881144,,,,,,,,,,N-T,,1,0,0,£114.00,1,GST,,0,1,0,0,0,0,0,114,20,20,20,20,20,0,0,0,0,0,0,0,0,0,0,0,0,0,0,0,0,0,0,0,0,0,0,0,0,Y,£68.18,,
ZZZ1129,Munro Pendulum Swinging Arm ,B,S,I,11201,43003,50001,Stock Code: 303200,,,,,,,,,,N-T,,1,0,0,£127.00,1,GST,,0,1,0,0,0,0,0,127,114,114,114,114,114,0,0,0,0,0,0,0,0,0,0,0,0,0,0,0,0,0,0,0,0,0,0,0,0,Y,£77.38,,
ZZZ1118,Munro Pendulum Bearing,B,S,I,11201,43003,50001,Stock Code: 101596,,,,,,,,,,N-T,,1,0,0,£34.00,1,GST,,0,1,0,0,0,0,0,34,127,127,127,127,127,0,0,0,0,0,0,0,0,0,0,0,0,0,0,0,0,0,0,0,0,0,0,0,0,Y,£11.09,,
ZZZ509,Cal Plate (NZ) - Pendulum,B,S,I,11201,43003,50001,,,,,,,,,,,GST,,1,0,0,£15.00,,GST,,0,1,0,0,0,0,0,15,15,15,15,15,15,0,0,0,0,0,0,0,0,0,0,0,0,0,0,0,0,0,0,0,0,0,0,0,0,Y,£8.50,,
ZZZ0004,Wessex Tortus 3 (Used),B,S,I,11201,43003,50001,,,,,,,,,QM Systems Ltd,,GST,,1,0,0,£0.00,,GST,,0,1,0,0,0,0,0,0,5500,5500,5500,5500,5500,0,0,0,0,0,0,0,0,0,0,0,0,0,0,0,0,0,0,0,0,0,0,0,0,Y,£0.00,,
ZZZ00001,Munro Pendulum,B,S,I,11201,43003,50001,,,,,,,,,QM Systems Ltd,,N-T,,1,0,0,"£13,550.00",,GST,,0,1,0,0,0,0,0,13550,13550,13550,13550,13550,13550,0,0,0,0,0,0,0,0,0,0,0,0,0,0,0,0,0,0,0,0,0,0,0,0,Y,"£7,191.31",,
ZZZ00002,Munro Pendulum (Digital),B,S,I,11201,43003,50001,,,,,,,,,QM Systems Ltd,,N-T,,1,0,0,£0.00,,GST,,0,1,0,0,0,0,0,0,0,0,0,0,0,0,0,0,0,0,0,0,0,0,0,0,0,0,0,0,0,0,0,0,0,0,0,0,0,Y,£0.00,,
ZZZ00003,Munro Pendulum (Used),B,S,I,11201,43003,50001,,,,,,,,,QM Systems Ltd,,N-T,,1,0,0,£0.00,,GST,,0,1,0,0,0,0,0,0,0,0,0,0,0,0,0,0,0,0,0,0,0,0,0,0,0,0,0,0,0,0,0,0,0,0,0,0,0,Y,£0.00,,
ZZZ5012,Shipping Fee S12,,S,,,42400,,,,,,,,,,,,,,,,,£300.00,1,GST,,0,1,0,0,0,0,0,300,229,229,229,229,229,0,0,0,0,0,0,0,0,0,0,0,0,0,0,0,0,0,0,0,0,0,0,0,0,Y,,,
ZZZ419,Packaging - Bubble Wrap,B,,I,11201,,,,,,,,,,,Bunnings Warehouse,,GST,,1,0,1,,,,,,,0,0,0,0,0,0,0,0,0,0,0,0,0,0,0,0,0,0,0,0,0,0,0,0,0,0,0,0,0,0,0,0,0,0,0,Y,£11.47,,
ZZZ2009,Tortus sliders (pack of 6),,S,I,11201,43003,50001,,,,,,2,,,,,,,,,0,£100.00,1,GST,,0,1,0,0,0,0,0,100,100,100,100,100,100,0,0,0,0,0,0,0,0,0,0,0,0,0,0,0,0,0,0,0,0,0,0,0,0,Y,,,
ZZZ1130,Munro Slider Measuring Tool,B,S,I,11201,43003,50001,,,,,,,,,Munro Instruments Limited,,N-T,1,1,0,1,£39.00,1,GST,,0,1,0,0,0,0,0,39,69,69,69,69,69,0,0,0,0,0,0,0,0,0,0,0,0,0,0,0,0,0,0,0,0,0,0,0,0,Y,£21.57,,
ZZZ1119,Munro 6BA Bolt,B,S,I,11201,43003,50001,,,,,,,,,Munro Instruments Limited,,N-T,1,1,0,1,£69.00,1,GST,,0,1,0,0,0,0,0,69,69,69,69,69,69,0,0,0,0,0,0,0,0,0,0,0,0,0,0,0,0,0,0,0,0,0,0,0,0,Y,£0.00,,
ZZZ708,Munro Verification Kit,B,S,I,11201,43003,50001,,,,,,,,,QM Systems Ltd,,N-T,1,1,0,2,"£1,250.00",,GST,,0,1,0,0,0,0,0,1250,19,19,19,19,19,0,0,0,0,0,0,0,0,0,0,0,0,0,0,0,0,0,0,0,0,0,0,0,0,Y,£0.00,,
ZZZ4002,Training - Pendulum AS/NZ4663,,S,,,43003,,,,,,,,,,,,,,,,,£0.00,1,GST,,0,1,0,0,0,0,0,0,995,995,995,995,995,0,0,0,0,0,0,0,0,0,0,0,0,0,0,0,0,0,0,0,0,0,0,0,0,Y,,,
ZZZ4003,Training - Pendulum SS485,,S,,,43003,,Introductory Training - Pendulum (SS 485),X,,,,,,,,,,,,,,£0.00,1,GST,,0,1,0,0,0,0,0,0,0,0,0,0,0,0,0,0,0,0,0,0,0,0,0,0,0,0,0,0,0,0,0,0,0,0,0,0,0,Y,,,
ZZZ4004,Training - Pendulum BS7976,,S,,,43003,,Introductory Training - Pendulum (BS 7976),X,,,,,,,,,,,,,,£0.00,1,GST,,0,1,0,0,0,0,0,0,0,0,0,0,0,0,0,0,0,0,0,0,0,0,0,0,0,0,0,0,0,0,0,0,0,0,0,0,0,Y,,,
ZZZ4005,Training -Pendulum CEN/TS16165,,S,,,43003,,Introductory Training - Pendulum (CEN/TS 16165),X,,,,,,,,,,,,,,£0.00,1,GST,,0,1,0,0,0,0,0,0,0,0,0,0,0,0,0,0,0,0,0,0,0,0,0,0,0,0,0,0,0,0,0,0,0,0,0,0,0,Y,,,
ZZZ4006,Training - Pendulum ASTM E303,,S,,,43003,,Introductory Training - Pendulum (ASTM E303),X,,,,,,,,,,,,,,£0.00,1,GST,,0,1,0,0,0,0,0,0,0,0,0,0,0,0,0,0,0,0,0,0,0,0,0,0,0,0,0,0,0,0,0,0,0,0,0,0,0,Y,,,
ZZZ4007,Training - Pendulum GB/T35153,,S,,,43003,,Introductory Training - Pendulum (GB/T 35153),X,,,,,,,,,,,,,,£0.00,1,GST,,0,1,0,0,0,0,0,0,0,0,0,0,0,0,0,0,0,0,0,0,0,0,0,0,0,0,0,0,0,0,0,0,0,0,0,0,0,Y,,,
ZZZ4008,Training Pendulum Verification,,S,,,43003,,Introductory Training - Pendulum Verification ,X,,,,,,,,,,,,,,£0.00,1,GST,,0,1,0,0,0,0,0,0,0,0,0,0,0,0,0,0,0,0,0,0,0,0,0,0,0,0,0,0,0,0,0,0,0,0,0,0,0,Y,,,
ZZZ4012,Training - Tortus AS/NZ4663,,S,,,43003,,Introductory Training - Tortus (AS/NZ 4663),X,,,,,,,,,,,,,,£0.00,1,GST,,0,1,0,0,0,0,0,0,0,0,0,0,0,0,0,0,0,0,0,0,0,0,0,0,0,0,0,0,0,0,0,0,0,0,0,0,0,Y,,,
ZZZ4013,Training Tortus Verification,,S,,,43003,,Introductory Training - Tortus Verification ,X,,,,,,,,,,,,,,£0.00,1,GST,,0,1,0,0,0,0,0,0,0,0,0,0,0,0,0,0,0,0,0,0,0,0,0,0,0,0,0,0,0,0,0,0,0,0,0,0,0,Y,,,
ZZZ5001,Shipping Fee S1,,S,,,43003,,,,,,,,,,,,,,,,,£25.00,1,GST,,0,1,0,0,0,0,0,25,25,25,25,25,25,0,0,0,0,0,0,0,0,0,0,0,0,0,0,0,0,0,0,0,0,0,0,0,0,Y,,,
ZZZ5002,Shipping Fee S2,,S,,,43003,,,,,,,,,,,,,,,,,£50.00,1,GST,,0,1,0,0,0,0,0,50,50,50,50,50,50,0,0,0,0,0,0,0,0,0,0,0,0,0,0,0,0,0,0,0,0,0,0,0,0,Y,,,
ZZZ5003,Shipping Fee S3,,S,,,43003,,,,,,,,,,,,,,,,,£75.00,1,GST,,0,1,0,0,0,0,0,75,75,75,75,75,75,0,0,0,0,0,0,0,0,0,0,0,0,0,0,0,0,0,0,0,0,0,0,0,0,Y,,,
ZZZ5004,Shipping Fee S4,,S,,,43003,,,,,,,,,,,,,,,,,£100.00,1,GST,,0,1,0,0,0,0,0,100,100,100,100,100,100,0,0,0,0,0,0,0,0,0,0,0,0,0,0,0,0,0,0,0,0,0,0,0,0,Y,,,
ZZZ5005,Shipping Fee S5,,S,,,43003,,,,,,,,,,,,,,,,,£125.00,1,GST,,0,1,0,0,0,0,0,125,125,125,125,125,125,0,0,0,0,0,0,0,0,0,0,0,0,0,0,0,0,0,0,0,0,0,0,0,0,Y,,,
ZZZ5011,Shipping Fee S11,,S,,,43003,,,,,,,,,,,,,,,,,£275.00,1,GST,,0,1,0,0,0,0,0,275,275,275,275,275,275,0,0,0,0,0,0,0,0,0,0,0,0,0,0,0,0,0,0,0,0,0,0,0,0,Y,,,
ZZZ5013,Shipping Fee S13,,S,,,43003,,,,,,,,,,,,,,,,,£325.00,1,GST,,0,1,0,0,0,0,0,325,325,325,325,325,325,0,0,0,0,0,0,0,0,0,0,0,0,0,0,0,0,0,0,0,0,0,0,0,0,Y,,,
ZZZ5014,Shipping Fee S14,,S,,,43003,,,,,,,,,,,,,,,,,£350.00,1,GST,,0,1,0,0,0,0,0,350,350,350,350,350,350,0,0,0,0,0,0,0,0,0,0,0,0,0,0,0,0,0,0,0,0,0,0,0,0,Y,,,
ZZZ5015,Shipping Fee S15,,S,,,43003,,,,,,,,,,,,,,,,,£375.00,1,GST,,0,1,0,0,0,0,0,375,375,375,375,375,375,0,0,0,0,0,0,0,0,0,0,0,0,0,0,0,0,0,0,0,0,0,0,0,0,Y,,,
ZZZ5016,Shipping Fee S16,,S,,,43003,,,,,,,,,,,,,,,,,£400.00,1,GST,,0,1,0,0,0,0,0,400,400,400,400,400,400,0,0,0,0,0,0,0,0,0,0,0,0,0,0,0,0,0,0,0,0,0,0,0,0,Y,,,
ZZZ5101,Training Travel Fee T1 ,,S,,,43003,,,,,,,,,,,,,,,,,£500.00,1,GST,,0,1,0,0,0,0,0,500,500,500,500,500,500,0,0,0,0,0,0,0,0,0,0,0,0,0,0,0,0,0,0,0,0,0,0,0,0,Y,,,
ZZZ5102,Training Travel Fee T2 ,,S,,,43003,,,,,,,,,,,,,,,,,£750.00,1,GST,,0,1,0,0,0,0,0,750,750,750,750,750,750,0,0,0,0,0,0,0,0,0,0,0,0,0,0,0,0,0,0,0,0,0,0,0,0,Y,,,
ZZZ5103,Training Travel Fee T3,,S,,,43003,,,,,,,,,,,,,,,,,"£1,000.00",1,GST,,0,1,0,0,0,0,0,1000,1000,1000,1000,1000,1000,0,0,0,0,0,0,0,0,0,0,0,0,0,0,0,0,0,0,0,0,0,0,0,0,Y,,,
ZZZ5104,Training Travel Fee T4,,S,,,43003,,,,,,,,,,,,,,,,,"£1,250.00",1,GST,,0,1,0,0,0,0,0,1250,1250,1250,1250,1250,1250,0,0,0,0,0,0,0,0,0,0,0,0,0,0,0,0,0,0,0,0,0,0,0,0,Y,,,
ZZZ5105,Training Travel Fee T5,,S,,,43003,,,,,,,,,,,,,,,,,"£1,500.00",1,GST,,0,1,0,0,0,0,0,1500,1500,1500,1500,1500,1500,0,0,0,0,0,0,0,0,0,0,0,0,0,0,0,0,0,0,0,0,0,0,0,0,Y,,,
ZZZ5111,Training Travel Fee T11,,S,,,43003,,Training Travel Fee A (International),X,,,,,,,,,,,,,,"£3,000.00",1,GST,,0,1,0,0,0,0,0,3000,3000,3000,3000,3000,3000,0,0,0,0,0,0,0,0,0,0,0,0,0,0,0,0,0,0,0,0,0,0,0,0,Y,,,
ZZZ5112,Training Travel Fee T12,,S,,,43003,,Training Travel Fee B (International),X,,,,,,,,,,,,,,"£3,250.00",1,GST,,0,1,0,0,0,0,0,3250,3250,3250,3250,3250,3250,0,0,0,0,0,0,0,0,0,0,0,0,0,0,0,0,0,0,0,0,0,0,0,0,Y,,,
ZZZ5113,Training Travel Fee T13,,S,,,43003,,Training Travel Fee C (International),X,,,,,,,,,,,,,,"£3,500.00",1,GST,,0,1,0,0,0,0,0,3500,3500,3500,3500,3500,3500,0,0,0,0,0,0,0,0,0,0,0,0,0,0,0,0,0,0,0,0,0,0,0,0,Y,,,
ZZZ5114,Training Travel Fee T14,,S,,,43003,,Training Travel Fee D (International),X,,,,,,,,,,,,,,"£3,750.00",1,GST,,0,1,0,0,0,0,0,3750,3750,3750,3750,3750,3750,0,0,0,0,0,0,0,0,0,0,0,0,0,0,0,0,0,0,0,0,0,0,0,0,Y,,,
ZZZ5115,Training Travel Fee T15,,S,,,43003,,Training Travel Fee E (International),X,,,,,,,,,,,,,,"£4,000.00",1,GST,,0,1,0,0,0,0,0,4000,4000,4000,4000,4000,4000,0,0,0,0,0,0,0,0,0,0,0,0,0,0,0,0,0,0,0,0,0,0,0,0,Y,,,
ZZZ171,Wessex Head Pivot Lock Nut,B,S,I,11201,43003,50001,,,,,,,,,,,N-T,,1,0,0,£0.00,,GST,,0,1,0,0,0,0,0,0,0,0,0,0,0,0,0,0,0,0,0,0,0,0,0,0,0,0,0,0,0,0,0,0,0,0,0,0,0,Y,£0.00,,
ZZZ172,Wessex Rear Frame Brass Nut,B,S,I,11201,43003,50001,,,,,,,,,,,N-T,,1,0,0,£0.00,,GST,,0,1,0,0,0,0,0,0,0,0,0,0,0,0,0,0,0,0,0,0,0,0,0,0,0,0,0,0,0,0,0,0,0,0,0,0,0,Y,£0.00,,
ZZZ173,Wessex Arm Assemby Cover weigh,B,S,I,11201,43003,50001,,,,,,,,,,,N-T,,1,0,0,£0.00,,GST,,0,1,0,0,0,0,0,0,0,0,0,0,0,0,0,0,0,0,0,0,0,0,0,0,0,0,0,0,0,0,0,0,0,0,0,0,0,Y,£0.00,,
ZZZ174,Wessex Rear Frame Foot Bot,B,S,I,11201,43003,50001,,,,,,,,,,,N-T,,1,0,0,£0.00,,GST,,0,1,0,0,0,0,0,0,0,0,0,0,0,0,0,0,0,0,0,0,0,0,0,0,0,0,0,0,0,0,0,0,0,0,0,0,0,Y,£0.00,,
ZZZ175,Wessex Base Block,B,S,I,11201,43003,50001,,,,,,,,,,,N-T,,1,0,0,£0.00,,GST,,0,1,0,0,0,0,0,0,0,0,0,0,0,0,0,0,0,0,0,0,0,0,0,0,0,0,0,0,0,0,0,0,0,0,0,0,0,Y,£0.00,,
ZZZ176,Wessex Rear Frame Block,B,S,I,11201,43003,50001,,,,,,,,,,,N-T,,1,0,0,£0.00,,GST,,0,1,0,0,0,0,0,0,0,0,0,0,0,0,0,0,0,0,0,0,0,0,0,0,0,0,0,0,0,0,0,0,0,0,0,0,0,Y,£0.00,,
ZZZ177,Wessex Head Locking Bracket ,B,S,I,11201,43003,50001,,,,,,,,,,,N-T,,1,0,0,£0.00,,GST,,0,1,0,0,0,0,0,0,0,0,0,0,0,0,0,0,0,0,0,0,0,0,0,0,0,0,0,0,0,0,0,0,0,0,0,0,0,Y,£0.00,,
ZZZ5006,Shipping Fee S6,,S,,,43003,,,,,,,,,,,,,,,,,£150.00,1,GST,,0,1,0,0,0,0,0,150,125,125,125,125,125,0,0,0,0,0,0,0,0,0,0,0,0,0,0,0,0,0,0,0,0,0,0,0,0,Y,,,
ZZZ5007,Shipping Fee S7,,S,,,43003,,,,,,,,,,,,,,,,,£175.00,1,GST,,0,1,0,0,0,0,0,175,150,150,150,150,150,0,0,0,0,0,0,0,0,0,0,0,0,0,0,0,0,0,0,0,0,0,0,0,0,Y,,,
ZZZ5008,Global Product Classification ,,S,,,43003,,,,,,,,,,,,,,,,,£200.00,1,GST,,0,1,0,0,0,0,0,200,175,175,175,175,175,0,0,0,0,0,0,0,0,0,0,0,0,0,0,0,0,0,0,0,0,0,0,0,0,Y,,,
ZZZ5000,GES- Pick up from ISTS HQ,,S,,,43003,,,,,,,,,,,,,,,,,£0.00,1,GST,,0,1,0,0,0,0,0,0,200,200,200,200,200,0,0,0,0,0,0,0,0,0,0,0,0,0,0,0,0,0,0,0,0,0,0,0,0,Y,,,
ZZZ5009,Shipping Fee S9,,S,,,43003,,,,,,,,,,,,,,,,,£225.00,1,GST,,0,1,0,0,0,0,0,225,225,225,225,225,225,0,0,0,0,0,0,0,0,0,0,0,0,0,0,0,0,0,0,0,0,0,0,0,0,Y,,,
ZZZ5010,Shipping Fee S10,,S,,,43003,,,,,,,,,,,,,,,,,£250.00,1,GST,,0,1,0,0,0,0,0,250,225,225,225,225,225,0,0,0,0,0,0,0,0,0,0,0,0,0,0,0,0,0,0,0,0,0,0,0,0,Y,,,
ZZZ5017,Shipping Fee S17,,S,,,43003,,,,,,,,,,,,,,,,,£425.00,1,GST,,0,1,0,0,0,0,0,425,400,400,400,400,400,0,0,0,0,0,0,0,0,0,0,0,0,0,0,0,0,0,0,0,0,0,0,0,0,Y,,,
ZZZ5018,Shipping Fee S18,,S,,,43003,,,,,,,,,,,,,,,,,£450.00,1,GST,,0,1,0,0,0,0,0,450,425,425,425,425,425,0,0,0,0,0,0,0,0,0,0,0,0,0,0,0,0,0,0,0,0,0,0,0,0,Y,,,
ZZZ5019,Shipping Fee S19,,S,,,43003,,,,,,,,,,,,,,,,,£475.00,1,GST,,0,1,0,0,0,0,0,475,450,450,450,450,450,0,0,0,0,0,0,0,0,0,0,0,0,0,0,0,0,0,0,0,0,0,0,0,0,Y,,,
ZZZ5020,Shipping Fee S20,,S,,,43003,,,,,,,,,,,,,,,,,£500.00,1,GST,,0,1,0,0,0,0,0,500,475,475,475,475,475,0,0,0,0,0,0,0,0,0,0,0,0,0,0,0,0,0,0,0,0,0,0,0,0,Y,,,
ZZZ5021,Shipping Fee S21,,S,,,43003,,,,,,,,,,,,,,,,,£550.00,1,GST,,0,1,0,0,0,0,0,550,500,500,500,500,500,0,0,0,0,0,0,0,0,0,0,0,0,0,0,0,0,0,0,0,0,0,0,0,0,Y,,,
ZZZ5022,Shipping Fee S22,,S,,,43003,,,,,,,,,,,,,,,,,£600.00,1,GST,,0,1,0,0,0,0,0,600,550,550,550,550,550,0,0,0,0,0,0,0,0,0,0,0,0,0,0,0,0,0,0,0,0,0,0,0,0,Y,,,
ZZZ5023,Shipping Fee S23,,S,,,43003,,,,,,,,,,,,,,,,,£650.00,1,GST,,0,1,0,0,0,0,0,650,600,600,600,600,600,0,0,0,0,0,0,0,0,0,0,0,0,0,0,0,0,0,0,0,0,0,0,0,0,Y,,,
ZZZ5024,Shipping Fee S24,,S,,,43003,,,,,,,,,,,,,,,,,£700.00,1,GST,,0,1,0,0,0,0,0,700,650,650,650,650,650,0,0,0,0,0,0,0,0,0,0,0,0,0,0,0,0,0,0,0,0,0,0,0,0,Y,,,
ZZZ5025,Shipping Fee S25,,S,,,43003,,,,,,,,,,,,,,,,,£750.00,1,GST,,0,1,0,0,0,0,0,750,700,700,700,700,700,0,0,0,0,0,0,0,0,0,0,0,0,0,0,0,0,0,0,0,0,0,0,0,0,Y,,,
ZZZ5100,Training Performed at ISTS HQ,,S,,,43003,,,,,,,,,,,,,,,,,£0.00,1,GST,,0,1,0,0,0,0,0,0,750,750,750,750,750,0,0,0,0,0,0,0,0,0,0,0,0,0,0,0,0,0,0,0,0,0,0,0,0,Y,,,
ZZZ5106,Training Travel Fee T6,,S,,,43003,,,,,,,,,,,,,,,,,"£1,750.00",1,GST,,0,1,0,0,0,0,0,1750,1500,1500,1500,1500,1500,0,0,0,0,0,0,0,0,0,0,0,0,0,0,0,0,0,0,0,0,0,0,0,0,Y,,,
ZZZ5107,Training Travel Fee T7,,S,,,43003,,,,,,,,,,,,,,,,,"£2,000.00",1,GST,,0,1,0,0,0,0,0,2000,1750,1750,1750,1750,1750,0,0,0,0,0,0,0,0,0,0,0,0,0,0,0,0,0,0,0,0,0,0,0,0,Y,,,
ZZZ5108,Training Travel Fee T8,,S,,,43003,,,,,,,,,,,,,,,,,"£2,250.00",1,GST,,0,1,0,0,0,0,0,2250,2000,2000,2000,2000,2000,0,0,0,0,0,0,0,0,0,0,0,0,0,0,0,0,0,0,0,0,0,0,0,0,Y,,,
ZZZ5109,Training Travel Fee T9,,S,,,43003,,,,,,,,,,,,,,,,,"£2,500.00",1,GST,,0,1,0,0,0,0,0,2500,2250,2250,2250,2250,2250,0,0,0,0,0,0,0,0,0,0,0,0,0,0,0,0,0,0,0,0,0,0,0,0,Y,,,
ZZZ5110,Training Travel Fee T10,,S,,,43003,,,,,,,,,,,,,,,,,"£2,750.00",1,GST,,0,1,0,0,0,0,0,2750,2500,2500,2500,2500,2500,0,0,0,0,0,0,0,0,0,0,0,0,0,0,0,0,0,0,0,0,0,0,0,0,Y,,,
ZZZ5116,Training Travel Fee T16,,S,,,43003,,,,,,,,,,,,,,,,,"£4,250.00",1,GST,,0,1,0,0,0,0,0,4250,4000,4000,4000,4000,4000,0,0,0,0,0,0,0,0,0,0,0,0,0,0,0,0,0,0,0,0,0,0,0,0,Y,,,
ZZZ5117,Training Travel Fee T17,,S,,,43003,,,,,,,,,,,,,,,,,"£4,500.00",1,GST,,0,1,0,0,0,0,0,4500,4250,4250,4250,4250,4250,0,0,0,0,0,0,0,0,0,0,0,0,0,0,0,0,0,0,0,0,0,0,0,0,Y,,,
ZZZ5118,Training Travel Fee T18,,S,,,43003,,,,,,,,,,,,,,,,,"£4,750.00",1,GST,,0,1,0,0,0,0,0,4750,4500,4500,4500,4500,4500,0,0,0,0,0,0,0,0,0,0,0,0,0,0,0,0,0,0,0,0,0,0,0,0,Y,,,
ZZZ5119,Training Travel Fee T19,,S,,,43003,,,,,,,,,,,,,,,,,"£5,000.00",1,GST,,0,1,0,0,0,0,0,5000,4750,4750,4750,4750,4750,0,0,0,0,0,0,0,0,0,0,0,0,0,0,0,0,0,0,0,0,0,0,0,0,Y,,,
ZZZ5120,Training Travel Fee T20,,S,,,43003,,,,,,,,,,,,,,,,,"£5,250.00",1,GST,,0,1,0,0,0,0,0,5250,5000,5000,5000,5000,5000,0,0,0,0,0,0,0,0,0,0,0,0,0,0,0,0,0,0,0,0,0,0,0,0,Y,,,
ZZZ5121,Training Travel Fee T21,,S,,,43003,,,,,,,,,,,,,,,,,"£5,500.00",1,GST,,0,1,0,0,0,0,0,5500,5250,5250,5250,5250,5250,0,0,0,0,0,0,0,0,0,0,0,0,0,0,0,0,0,0,0,0,0,0,0,0,Y,,,
ZZZ5122,Training Travel Fee T22,,S,,,43003,,,,,,,,,,,,,,,,,"£5,750.00",1,GST,,0,1,0,0,0,0,0,5750,5500,5500,5500,5500,5500,0,0,0,0,0,0,0,0,0,0,0,0,0,0,0,0,0,0,0,0,0,0,0,0,Y,,,
ZZZ5123,Training Travel Fee T23,,S,,,43003,,,,,,,,,,,,,,,,,"£6,000.00",1,GST,,0,1,0,0,0,0,0,6000,5750,5750,5750,5750,5750,0,0,0,0,0,0,0,0,0,0,0,0,0,0,0,0,0,0,0,0,0,0,0,0,Y,,,
ZZZ5124,Training Travel Fee T24,,S,,,43003,,,,,,,,,,,,,,,,,"£6,250.00",1,GST,,0,1,0,0,0,0,0,6250,6000,6000,6000,6000,6000,0,0,0,0,0,0,0,0,0,0,0,0,0,0,0,0,0,0,0,0,0,0,0,0,Y,,,
ZZZ5125,Training Travel Fee T25,,S,,,43003,,,,,,,,,,,,,,,,,"£6,500.00",1,GST,,0,1,0,0,0,0,0,6500,6250,6250,6250,6250,6250,0,0,0,0,0,0,0,0,0,0,0,0,0,0,0,0,0,0,0,0,0,0,0,0,Y,,,
ZZZ2010,Munro Float Glass,B,S,I,11201,43003,50001,,,,,,,,,,,N-T,,1,0,0,£173.00,,GST,,0,1,0,0,0,0,0,173,173,173,173,173,173,0,0,0,0,0,0,0,0,0,0,0,0,0,0,0,0,0,0,0,0,0,0,0,0,Y,£96.17,,
ZZZ2011,Munro Pavigres Tiles,B,S,I,11201,43003,50001,,,,,,,,,,,N-T,,1,0,0,£191.00,,GST,,0,1,0,0,0,0,0,191,173,173,173,173,173,0,0,0,0,0,0,0,0,0,0,0,0,0,0,0,0,0,0,0,0,0,0,0,0,Y,£107.87,,
ZZZ246,Tortus Slider Conditioning Jig,B,S,I,11201,43003,50001,,,,,,,,,QM Systems Ltd,,GST,1,1,0,2,£55.00,,GST,,0,1,0,0,0,0,0,55,55,55,55,55,55,0,0,0,0,0,0,0,0,0,0,0,0,0,0,0,0,0,0,0,0,0,0,0,0,Y,£0.00,,
ZZZ1131,Munro Beaing Spindle,B,S,I,11201,43003,50001,,,,,,,,,,,N-T,,1,0,0,£0.00,,GST,,0,1,0,0,0,0,0,0,0,0,0,0,0,0,0,0,0,0,0,0,0,0,0,0,0,0,0,0,0,0,0,0,0,0,0,0,0,Y,£0.00,,
ZZZ178,Wessex Pendulum Pivot Bearing,B,S,I,11201,43003,50001,Wessex Pendulum Head Pivot Bearing,,,,,4,,,,,GST,,1,0,0,£15.00,,GST,,0,1,0,0,0,0,0,15,15,15,15,15,15,0,0,0,0,0,0,0,0,0,0,0,0,0,0,0,0,0,0,0,0,0,0,0,0,Y,£10.14,,
ZZZ179,Wessex Pendulum Foot Strap,,S,I,11201,43003,50001,Wessex Pendulum Foot Strap,,,,,4,,,,,,,,,0,£14.00,,GST,,0,1,0,0,0,0,0,14,15,15,15,15,15,0,0,0,0,0,0,0,0,0,0,0,0,0,0,0,0,0,0,0,0,0,0,0,0,Y,,,
ZZZ180,Wessex Pendulum M8 Lock Nut,B,S,I,11201,43003,50001,Wessex Pendulum M8 Locking Nut,,,,,6,,,,,GST,,1,0,0,£1.00,,GST,,0,1,0,0,0,0,0,1,14,14,14,14,14,0,0,0,0,0,0,0,0,0,0,0,0,0,0,0,0,0,0,0,0,0,0,0,0,Y,£0.54,,
ZZZ181,Wessex MK1 Pointer Counter Bal,B,S,I,11201,43003,50001,Wessex Pendulum MK1 Pointer Counter Balance - For new Wessex Pendulum Model.,,,,,,,,,,N-T,,1,0,0,£199.00,,GST,,0,1,0,0,0,0,0,199,149,149,149,149,149,0,0,0,0,0,0,0,0,0,0,0,0,0,0,0,0,0,0,0,0,0,0,0,0,Y,£141.78,,
ZZZ182,Wessex Base (Loose),B,S,I,11201,43003,50001,,,,,,,,,,,N-T,,1,0,1,£345.00,,GST,,0,1,0,0,0,0,0,345,149,149,149,149,149,0,0,0,0,0,0,0,0,0,0,0,0,0,0,0,0,0,0,0,0,0,0,0,0,Y,£245.99,,
ZZZ183,Wessex Base (Fixed),B,S,I,11201,43003,50001,,,,,,,,,,,N-T,,1,0,1,£187.00,,GST,,0,1,0,0,0,0,0,187,345,345,345,345,345,0,0,0,0,0,0,0,0,0,0,0,0,0,0,0,0,0,0,0,0,0,0,0,0,Y,£132.99,,
ZZZ184,Wessex Main Spindle,B,S,I,11201,43003,50001,,,,,,,,,,,N-T,,1,0,1,£128.00,,GST,,0,1,0,0,0,0,0,128,187,187,187,187,187,0,0,0,0,0,0,0,0,0,0,0,0,0,0,0,0,0,0,0,0,0,0,0,0,Y,£91.28,,
ZZZ185,Wessex Intermediate Spindle,B,S,I,11201,43003,50001,,,,,,,,,,,N-T,,1,0,1,£184.00,,GST,,0,1,0,0,0,0,0,184,128,128,128,128,128,0,0,0,0,0,0,0,0,0,0,0,0,0,0,0,0,0,0,0,0,0,0,0,0,Y,£130.99,,
ZZZ186,Wessex Split Cotter,B,S,I,11201,43003,50001,,,,,,,,,,,N-T,,1,0,1,£69.00,,GST,,0,1,0,0,0,0,0,69,184,184,184,184,184,0,0,0,0,0,0,0,0,0,0,0,0,0,0,0,0,0,0,0,0,0,0,0,0,Y,£49.24,,
ZZZ187,Wessex Jacking Screw & Nut ,B,S,I,11201,43003,50001,,,,,,,,,,,N-T,,1,0,1,£227.00,,GST,,0,1,0,0,0,0,0,227,69,69,69,69,69,0,0,0,0,0,0,0,0,0,0,0,0,0,0,0,0,0,0,0,0,0,0,0,0,Y,£161.51,,
ZZZ188,Wessex Pendulum Pointer (ES),B,S,I,11201,43003,50001,,,,,,,,,Wessex Engineering,,N-T,,1,0,0,£245.00,,GST,,0,1,0,0,0,0,0,245,245,245,245,245,245,0,0,0,0,0,0,0,0,0,0,0,0,0,0,0,0,0,0,0,0,0,0,0,0,Y,£130.00,,
ZZZ189,Wessex Pendulum Point Ring (ES,B,S,I,11201,43003,50001,,,,,,,,,Wessex Engineering,,N-T,,1,0,0,£245.00,,GST,,0,1,0,0,0,0,0,245,245,245,245,245,245,0,0,0,0,0,0,0,0,0,0,0,0,0,0,0,0,0,0,0,0,0,0,0,0,Y,£130.00,,
ZZZ1132,Munro Pendulum Grub Screw,B,S,I,11201,43003,50001,,,,,,,,,Wynnum Bearings and Bolts,1132,GST,,1,0,0,£1.00,,GST,,0,1,0,0,0,0,0,1,1,1,1,1,1,0,0,0,0,0,0,0,0,0,0,0,0,0,0,0,0,0,0,0,0,0,0,0,0,Y,£0.00,,
ZZZ247,Tortus USB Stick (Lexar),B,,I,11201,,,,,,,,,,,Wessex Engineering,,GST,,1,0,0,,,,,,,0,0,0,0,0,0,0,0,0,0,0,0,0,0,0,0,0,0,0,0,0,0,0,0,0,0,0,0,0,0,0,0,0,0,0,Y,£0.00,,
ZZZ190,Wessex Pendulum Head Large,B,S,I,11201,43003,50001,,,,,,,,,Wynnum Bearings and Bolts,,GST,,1,0,0,£1.00,,GST,,0,1,0,0,0,0,0,1,1,1,1,1,1,0,0,0,0,0,0,0,0,0,0,0,0,0,0,0,0,0,0,0,0,0,0,0,0,Y,£0.00,,
ZZZ1133,Encoder Sensor C/W Magnet,B,S,I,11201,43003,50001,,,,,,,,,Munro Instruments Limited,,N-T,,1,0,0,£0.00,,GST,,0,1,0,0,0,0,0,0,0,0,0,0,0,0,0,0,0,0,0,0,0,0,0,0,0,0,0,0,0,0,0,0,0,0,0,0,0,Y,£101.44,,
ZZZ1134,Munro Pendulum Flight Case,B,S,I,11201,43003,50001,,,,,,,,,Munro Instruments Limited,303390,N-T,,1,0,0,"£2,895.00",,GST,,0,1,0,0,0,0,0,2895,2895,2895,2895,2895,2895,0,0,0,0,0,0,0,0,0,0,0,0,0,0,0,0,0,0,0,0,0,0,0,0,Y,£0.00,,
ZZZ4009,Pendulum Calibration Procedure,,S,,,43003,,,,,,,,,,,,,,,,,£0.00,,GST,,0,1,0,0,0,0,0,0,0,0,0,0,0,0,0,0,0,0,0,0,0,0,0,0,0,0,0,0,0,0,0,0,0,0,0,0,0,Y,,,
ZZZ5126,Labour Diagnostic on USB Board,,S,,,43003,,,,,,,,,,,,,,,,,£0.00,,GST,,0,1,0,0,0,0,0,0,0,0,0,0,0,0,0,0,0,0,0,0,0,0,0,0,0,0,0,0,0,0,0,0,0,0,0,0,0,Y,,,
ZZZ1135,Munro Pendulum Levelling Screw,B,S,I,11201,43003,50001,,,,,,,,,,,N-T,,1,0,0,£168.00,,GST,,0,1,0,0,0,0,0,168,168,168,168,168,168,0,0,0,0,0,0,0,0,0,0,0,0,0,0,0,0,0,0,0,0,0,0,0,0,Y,£0.00,,
ZZZ1136,Munro Rack,B,S,I,11201,43003,50001,,,,,,,,,,,N-T,,1,0,0,£200.00,1,GST,,0,1,0,0,0,0,0,200,20,20,20,20,20,0,0,0,0,0,0,0,0,0,0,0,0,0,0,0,0,0,0,0,0,0,0,0,0,Y,£0.00,,
ZZZ1137,Munro Pendulum Foot Plate,B,S,I,11201,43003,50001,,,,,,,,,,,GST,,1,0,0,£15.00,,GST,,0,1,0,0,0,0,0,15,15,15,15,15,15,0,0,0,0,0,0,0,0,0,0,0,0,0,0,0,0,0,0,0,0,0,0,0,0,Y,£0.00,,
ZZZ191,Sample Holder in Aluminium,B,S,I,11201,43003,50001,,,,,,,,,Laboratorio de Resbaladicidad SL,,N-T,,1,0,0,£0.00,,GST,,0,1,0,0,0,0,0,0,0,0,0,0,0,0,0,0,0,0,0,0,0,0,0,0,0,0,0,0,0,0,0,0,0,0,0,0,0,Y,£485.64,,
ZZZ3006,Equipment Repair- Tortus (Othe,,S,,,43003,,,,,,,,,,,,,,,,,£0.00,,GST,,0,1,0,0,0,0,0,0,0,0,0,0,0,0,0,0,0,0,0,0,0,0,0,0,0,0,0,0,0,0,0,0,0,0,0,0,0,Y,,,
M001,Munro Pendulum (Analogue),B,S,I,11201,43003,50001,,,,,,,,,Munro Instruments Limited,,N-T,,1,0,0,£0.00,,GST,,0,1,0,0,0,0,0,0,14,14,14,14,14,0,0,0,0,0,0,0,0,0,0,0,0,0,0,0,0,0,0,0,0,0,0,0,0,N,£0.00,,
M002,Munro Pendulum (Digital),B,S,I,11201,43003,50001,,,,,,,,,Munro Instruments Limited,,N-T,,1,0,0,£0.00,,GST,,0,1,0,0,0,0,0,0,13500,13500,13500,13500,13500,0,0,0,0,0,0,0,0,0,0,0,0,0,0,0,0,0,0,0,0,0,0,0,0,N,£0.00,,
M003,Munro Pendulum (Used),B,S,I,11201,43003,50001,,,,,,,,,Munro Instruments Limited,,N-T,,1,0,0,£0.00,,GST,,0,1,0,0,0,0,0,0,0,0,0,0,0,0,0,0,0,0,0,0,0,0,0,0,0,0,0,0,0,0,0,0,0,0,0,0,0,N,£0.00,,
WL001,WammaLab Pendulum,B,S,I,11201,43003,50001,,,,,,,,,Laboratorio de Resbaladicidad SL,,N-T,,1,0,0,"£11,575.00",,GST,,0,1,0,0,0,0,0,11575,10550,10550,10550,10550,10550,0,0,0,0,0,0,0,0,0,0,0,0,0,0,0,0,0,0,0,0,0,0,0,0,N,"£5,567.34",,
WL002,WammaLab Pendulum (Used),B,S,I,11201,43003,50001,,,,,,,,,Laboratorio de Resbaladicidad SL,,N-T,,1,0,0,"£8,750.00",,GST,,0,1,0,0,0,0,0,8750,7500,7500,7500,7500,7500,0,0,0,0,0,0,0,0,0,0,0,0,0,0,0,0,0,0,0,0,0,0,0,0,N,£0.00,,
WL003,WammaLab Pen Calibration Rig,B,S,I,11201,43003,50001,,,,,,,,,Laboratorio de Resbaladicidad SL,,N-T,,1,0,0,"£3,800.00",,GST,,0,1,0,0,0,0,0,3800,3800,3800,3800,3800,3800,0,0,0,0,0,0,0,0,0,0,0,0,0,0,0,0,0,0,0,0,0,0,0,0,N,£0.00,,
WSX001,Wessex Tortus3,B,S,I,11201,43003,50001,,,,,,,,,QM Systems Ltd,,N-T,,1,0,0,£0.00,,GST,,0,1,0,0,0,0,0,0,9950,9950,9950,9950,9950,0,0,0,0,0,0,0,0,0,0,0,0,0,0,0,0,0,0,0,0,0,0,0,0,N,£0.00,,
WSX002,Wessex Tortus3 (Used),B,S,I,11201,43003,50001,,,,,,,,,QM Systems Ltd,,N-T,,1,0,0,£0.00,,GST,,0,1,0,0,0,0,0,0,0,0,0,0,0,0,0,0,0,0,0,0,0,0,0,0,0,0,0,0,0,0,0,0,0,0,0,0,0,N,£0.00,,
WS003,Wessex Pendulum,B,S,I,11201,43003,50001,,,,,,,,,QM Systems Ltd,,N-T,,1,0,0,£0.00,,GST,,0,1,0,0,0,0,0,0,0,0,0,0,0,0,0,0,0,0,0,0,0,0,0,0,0,0,0,0,0,0,0,0,0,0,0,0,0,Y,£0.00,,
WS004,Wessex Pendulum (Used),B,S,I,11201,43003,50001,,,,,,,,,Laboratorio de Resbaladicidad SL,,N-T,,1,0,0,£0.00,,GST,,0,1,0,0,0,0,0,0,0,0,0,0,0,0,0,0,0,0,0,0,0,0,0,0,0,0,0,0,0,0,0,0,0,0,0,0,0,Y,£0.00,,
M004,Munro Levelling Feet Asse-Rubb,B,S,I,11201,43003,50001,,,,,,,,,Munro Instruments Limited,,N-T,,1,0,0,£180.00,,GST,,0,1,0,0,0,0,0,180,155,155,155,155,155,0,0,0,0,0,0,0,0,0,0,0,0,0,0,0,0,0,0,0,0,0,0,0,0,N,£0.00,,
M005,Munro Levelling Feet Asse-Scre,B,S,I,11201,43003,50001,,,,,,,,,Munro Instruments Limited,,N-T,,1,0,0,£150.00,,GST,,0,1,0,0,0,0,0,150,131.14,131.14,131.14,131.14,131.14,0,0,0,0,0,0,0,0,0,0,0,0,0,0,0,0,0,0,0,0,0,0,0,0,N,£0.00,,
M006,Munro Pendulum Base,B,S,I,11201,43003,50001,,,,,,,,,Munro Instruments Limited,,N-T,,1,0,0,£0.00,,GST,,0,1,0,0,0,0,0,0,0,0,0,0,0,0,0,0,0,0,0,0,0,0,0,0,0,0,0,0,0,0,0,0,0,0,0,0,0,N,£0.00,,
M007,Munro Pendulum Rear Leg,B,S,I,11201,43003,50001,,,,,,,,,Munro Instruments Limited,,N-T,,1,0,0,£0.00,,GST,,0,1,0,0,0,0,0,0,0,0,0,0,0,0,0,0,0,0,0,0,0,0,0,0,0,0,0,0,0,0,0,0,0,0,0,0,0,N,£0.00,,
M008,Munro Pendulum Face Plate,B,S,I,11201,43003,50001,,,,,,,,,Munro Instruments Limited,,N-T,,1,0,0,£0.00,,GST,,0,1,0,0,0,0,0,0,0,0,0,0,0,0,0,0,0,0,0,0,0,0,0,0,0,0,0,0,0,0,0,0,0,0,0,0,0,N,£0.00,,
M009,Munro Pendulum Arm,B,S,I,11201,43003,50001,,,,,,,,,Munro Instruments Limited,,N-T,,1,0,0,£145.00,,GST,,0,1,0,0,0,0,0,145,130,130,130,130,130,0,0,0,0,0,0,0,0,0,0,0,0,0,0,0,0,0,0,0,0,0,0,0,0,N,£0.00,,
M010,Munro Pend Spring Tension Ass,B,S,I,11201,43003,50001,,,,,,,,,Munro Instruments Limited,,N-T,,1,0,0,£288.00,,GST,,0,1,0,0,0,0,0,288,165,165,165,165,165,0,0,0,0,0,0,0,0,0,0,0,0,0,0,0,0,0,0,0,0,0,0,0,0,N,£0.00,,
M011,Munro Pend Spring Tension Bras,B,S,I,11201,43003,50001,,,,,,,,,Munro Instruments Limited,,N-T,,1,0,0,£75.00,,GST,,0,1,0,0,0,0,0,75,55,55,55,55,55,0,0,0,0,0,0,0,0,0,0,0,0,0,0,0,0,0,0,0,0,0,0,0,0,N,£0.00,,
M012,Munro Pendulum Tension Spring,B,S,I,11201,43003,50001,,,,,,,,,Munro Instruments Limited,,N-T,,1,0,0,£60.00,,GST,,0,1,0,0,0,0,0,60,60,60,60,60,60,0,0,0,0,0,0,0,0,0,0,0,0,0,0,0,0,0,0,0,0,0,0,0,0,N,£0.00,,
M013,Munro Friction Adjustment Ring,B,S,I,11201,43003,50001,,,,,,,,,Munro Instruments Limited,,N-T,,1,0,0,£80.00,,GST,,0,1,0,0,0,0,0,80,80,80,80,80,80,0,0,0,0,0,0,0,0,0,0,0,0,0,0,0,0,0,0,0,0,0,0,0,0,N,£0.00,,
M014,Munro Bearing Hub Brass Housi ,B,S,I,11201,43003,50001,,,,,,,,,Munro Instruments Limited,,N-T,,1,0,0,£250.00,,GST,,0,1,0,0,0,0,0,250,250,250,250,250,250,0,0,0,0,0,0,0,0,0,0,0,0,0,0,0,0,0,0,0,0,0,0,0,0,N,£0.00,,
M015,Munro Bearing Hub Fixing Plate,B,S,I,11201,43003,50001,,,,,,,,,Munro Instruments Limited,,N-T,,1,0,0,£185.00,,GST,,0,1,0,0,0,0,0,185,185,185,185,185,185,0,0,0,0,0,0,0,0,0,0,0,0,0,0,0,0,0,0,0,0,0,0,0,0,N,£0.00,,
M016,Munro Bearing Hub Main Housing,B,S,I,11201,43003,50001,,,,,,,,,Munro Instruments Limited,,N-T,,1,0,0,£0.00,,GST,,0,1,0,0,0,0,0,0,0,0,0,0,0,0,0,0,0,0,0,0,0,0,0,0,0,0,0,0,0,0,0,0,0,0,0,0,0,N,£0.00,,
M017,Munro Bearing Hub Spindle,B,S,I,11201,43003,50001,,,,,,,,,Munro Instruments Limited,,N-T,,1,0,0,£245.00,,GST,,0,1,0,0,0,0,0,245,245,245,245,245,245,0,0,0,0,0,0,0,0,0,0,0,0,0,0,0,0,0,0,0,0,0,0,0,0,N,£0.00,,
M018,Munro Head Locking Knob,B,S,I,11201,43003,50001,,,,,,,,,Munro Instruments Limited,,N-T,,1,0,0,£50.00,,GST,,0,1,0,0,0,0,0,50,50,50,50,50,50,0,0,0,0,0,0,0,0,0,0,0,0,0,0,0,0,0,0,0,0,0,0,0,0,N,£0.00,,
M019,Munro Pendulum Bullseye Level,B,S,I,11201,43003,50001,,,,,,,,,Munro Instruments Limited,,N-T,,1,0,0,£50.00,,GST,,0,1,0,0,0,0,0,50,45,45,45,45,45,0,0,0,0,0,0,0,0,0,0,0,0,0,0,0,0,0,0,0,0,0,0,0,0,N,£0.00,,
M020,Munro Height Adjustment Rack,B,S,I,11201,43003,50001,,,,,,,,,Munro Instruments Limited,,N-T,,1,0,0,£155.00,,GST,,0,1,0,0,0,0,0,155,155,155,155,155,155,0,0,0,0,0,0,0,0,0,0,0,0,0,0,0,0,0,0,0,0,0,0,0,0,N,£0.00,,
M021,Munro Height Adj Rack Spindle,B,S,I,11201,43003,50001,,,,,,,,,Munro Instruments Limited,,N-T,,1,0,0,£120.00,,GST,,0,1,0,0,0,0,0,120,120,120,120,120,120,0,0,0,0,0,0,0,0,0,0,0,0,0,0,0,0,0,0,0,0,0,0,0,0,N,£0.00,,
M022,Munro Bearing Hub Nut Cover,B,S,I,11201,43003,50001,,,,,,,,,Munro Instruments Limited,,N-T,,1,0,0,£50.00,,GST,,0,1,0,0,0,0,0,50,50,50,50,50,50,0,0,0,0,0,0,0,0,0,0,0,0,0,0,0,0,0,0,0,0,0,0,0,0,N,£0.00,,
M023,Munro Pendulum Felt Friction R,B,S,I,11201,43003,50001,,,,,,,,,Munro Instruments Limited,,N-T,,1,0,0,£40.00,,GST,,0,1,0,0,0,0,0,40,11,11,11,11,11,0,0,0,0,0,0,0,0,0,0,0,0,0,0,0,0,0,0,0,0,0,0,0,0,N,£0.00,,
M024,Munro Pointer Counter Bal Ring,B,S,I,11201,43003,50001,,,,,,,,,Munro Instruments Limited,,N-T,,1,0,0,£150.00,,GST,,0,1,0,0,0,0,0,150,150,150,150,150,150,0,0,0,0,0,0,0,0,0,0,0,0,0,0,0,0,0,0,0,0,0,0,0,0,N,£0.00,,
M025,Munro Pendulum Pointer,B,S,I,11201,43003,50001,,,,,,,,,Munro Instruments Limited,,N-T,,1,0,0,£100.00,,GST,,0,1,0,0,0,0,0,100,75,75,75,75,75,0,0,0,0,0,0,0,0,0,0,0,0,0,0,0,0,0,0,0,0,0,0,0,0,N,£0.00,,
M026,Pointer Adjustment Strike,B,S,I,11201,43003,50001,,,,,,,,,Munro Instruments Limited,,N-T,,1,0,0,£130.00,,GST,,0,1,0,0,0,0,0,130,130,130,130,130,130,0,0,0,0,0,0,0,0,0,0,0,0,0,0,0,0,0,0,0,0,0,0,0,0,N,£0.00,,
M027,Arm Catch/Release Block,B,S,I,11201,43003,50001,,,,,,,,,Munro Instruments Limited,,N-T,,1,0,0,£0.00,,GST,,0,1,0,0,0,0,0,0,0,0,0,0,0,0,0,0,0,0,0,0,0,0,0,0,0,0,0,0,0,0,0,0,0,0,0,0,0,N,£0.00,,
M028,Pendulum Carry Handle,B,S,I,11201,43003,50001,,,,,,,,,Munro Instruments Limited,,N-T,,1,0,0,£140.00,1,GST,,0,1,0,0,0,0,0,140,120,120,120,120,120,0,0,0,0,0,0,0,0,0,0,0,0,0,0,0,0,0,0,0,0,0,0,0,0,N,£0.00,,
M029,Munro Pendulum Bearing,B,S,I,11201,43003,50001,,,,,,,,,Munro Instruments Limited,,N-T,,1,0,0,£18.00,,GST,,0,1,0,0,0,0,0,18,15,15,15,15,15,0,0,0,0,0,0,0,0,0,0,0,0,0,0,0,0,0,0,0,0,0,0,0,0,N,£0.00,,
M030,Munro Pendulum Foot Base Plate,B,S,I,11201,43003,50001,,,,,,,,,Munro Instruments Limited,,N-T,,1,0,0,£40.00,,GST,,0,1,0,0,0,0,0,40,30.8,30.8,30.8,30.8,30.8,0,0,0,0,0,0,0,0,0,0,0,0,0,0,0,0,0,0,0,0,0,0,0,0,N,£0.00,,
M031,Munro Foot Pivot Assembly,B,S,I,11201,43003,50001,,,,,,,,,Munro Instruments Limited,,N-T,,1,0,0,£225.00,,GST,,0,1,0,0,0,0,0,225,217,217,217,217,217,0,0,0,0,0,0,0,0,0,0,0,0,0,0,0,0,0,0,0,0,0,0,0,0,N,£0.00,,
M032,Munro Pendulum Foot Counterwgt,B,S,I,11201,43003,50001,,,,,,,,,Munro Instruments Limited,,N-T,,1,0,0,£115.00,,GST,,0,1,0,0,0,0,0,115,115,115,115,115,115,0,0,0,0,0,0,0,0,0,0,0,0,0,0,0,0,0,0,0,0,0,0,0,0,N,£0.00,,
M033,Munro Pendulum Slider Pin,B,S,I,11201,43003,50001,,,,,,,,,Munro Instruments Limited,,N-T,,1,0,0,£10.00,,GST,,0,1,0,0,0,0,0,10,6,6,6,6,6,0,0,0,0,0,0,0,0,0,0,0,0,0,0,0,0,0,0,0,0,0,0,0,0,N,£0.00,,
M034,Munro Pendulum Slider Spring,B,S,I,11201,43003,50001,,,,,,,,,Munro Instruments Limited,,N-T,,1,0,0,£28.00,,GST,,0,1,0,0,0,0,0,28,26,26,26,26,26,0,0,0,0,0,0,0,0,0,0,0,0,0,0,0,0,0,0,0,0,0,0,0,0,N,£0.00,,
M035,Munro Slider Lifting Arm,B,S,I,11201,43003,50001,,,,,,,,,Munro Instruments Limited,,N-T,,1,0,0,£180.00,,GST,,0,1,0,0,0,0,0,180,180,180,180,180,180,0,0,0,0,0,0,0,0,0,0,0,0,0,0,0,0,0,0,0,0,0,0,0,0,N,£0.00,,
M036,Munro Slider Measuring Tool,B,S,I,11201,43003,50001,,,,,,,,,Munro Instruments Limited,,N-T,,1,0,0,£55.00,,GST,,0,1,0,0,0,0,0,55,55,55,55,55,55,0,0,0,0,0,0,0,0,0,0,0,0,0,0,0,0,0,0,0,0,0,0,0,0,N,£0.00,,
M037,Munro Pendulum Tool Kit,B,S,I,11201,43003,50001,,,,,,,,,Munro Instruments Limited,,N-T,,1,0,0,£180.00,,GST,,0,1,0,0,0,0,0,180,160,160,160,160,160,0,0,0,0,0,0,0,0,0,0,0,0,0,0,0,0,0,0,0,0,0,0,0,0,N,£0.00,,
M038,Munro Pendulum Wiring Loom,B,S,I,11201,43003,50001,,,,,,,,,Munro Instruments Limited,,N-T,,1,0,0,£160.00,,GST,,0,1,0,0,0,0,0,160,160,160,160,160,160,0,0,0,0,0,0,0,0,0,0,0,0,0,0,0,0,0,0,0,0,0,0,0,0,N,£0.00,,
M039,Munro Pendulum Digital Sensor,B,S,I,11201,43003,50001,,,,,,,,,Munro Instruments Limited,,N-T,,1,0,0,£150.00,,GST,,0,1,0,0,0,0,0,150,145,145,145,145,145,0,0,0,0,0,0,0,0,0,0,0,0,0,0,0,0,0,0,0,0,0,0,0,0,N,£0.00,,
M040,Munro Verification Plat Holder,B,S,I,11201,43003,50001,,,,,,,,,Munro Instruments Limited,,N-T,,1,0,0,£930.00,,GST,,0,1,0,0,0,0,0,930,880,880,880,880,880,0,0,0,0,0,0,0,0,0,0,0,0,0,0,0,0,0,0,0,0,0,0,0,0,N,£0.00,,
M041,Munro Pendulum Flight Case,B,S,I,11201,43003,50001,,,,,,,,,Munro Instruments Limited,,N-T,,1,0,0,"£3,360.00",,GST,,0,1,0,0,0,0,0,3360,3360,3360,3360,3360,3360,0,0,0,0,0,0,0,0,0,0,0,0,0,0,0,0,0,0,0,0,0,0,0,0,N,£0.00,,
WL004,WammaLab Pendulum Hgh Fric Pad,B,S,I,11201,43003,50001,,,,,,,,,Munro Instruments Limited,,N-T,,1,0,0,£40.00,,GST,,0,1,0,0,0,0,0,40,35,35,35,35,35,0,0,0,0,0,0,0,0,0,0,0,0,0,0,0,0,0,0,0,0,0,0,0,0,N,£0.00,,
WL005,WammaLab Pendulum Base (refurb,B,S,I,11201,43003,50001,,,,,,,,,Laboratorio de Resbaladicidad SL,,N-T,,1,0,0,£575.00,,GST,,0,1,0,0,0,0,0,575,345,345,345,345,345,0,0,0,0,0,0,0,0,0,0,0,0,0,0,0,0,0,0,0,0,0,0,0,0,N,£0.00,,
WL006,WammaLab Pendulum Rear Leg,B,S,I,11201,43003,50001,,,,,,,,,Laboratorio de Resbaladicidad SL,,N-T,,1,0,0,£0.00,,GST,,0,1,0,0,0,0,0,0,0,0,0,0,0,0,0,0,0,0,0,0,0,0,0,0,0,0,0,0,0,0,0,0,0,0,0,0,0,N,£0.00,,
WL007,WammaLab Pendulum Base Block,B,S,I,11201,43003,50001,,,,,,,,,Laboratorio de Resbaladicidad SL,,N-T,,1,0,0,£190.00,,GST,,0,1,0,0,0,0,0,190,190,190,190,190,190,0,0,0,0,0,0,0,0,0,0,0,0,0,0,0,0,0,0,0,0,0,0,0,0,N,£0.00,,
WL008,WammaLab Levelling Feet Knob,B,S,I,11201,43003,50001,,,,,,,,,Laboratorio de Resbaladicidad SL,,N-T,,1,0,0,£10.00,,GST,,0,1,0,0,0,0,0,10,7.5,7.5,7.5,7.5,7.5,0,0,0,0,0,0,0,0,0,0,0,0,0,0,0,0,0,0,0,0,0,0,0,0,N,£4.17,,
WL009,WammaLab Pendu level Feet Base,B,S,I,11201,43003,50001,,,,,,,,,Laboratorio de Resbaladicidad SL,,N-T,,1,0,0,£45.00,,GST,,0,1,0,0,0,0,0,45,40,40,40,40,40,0,0,0,0,0,0,0,0,0,0,0,0,0,0,0,0,0,0,0,0,0,0,0,0,N,£4.64,,
WL010,WammaLab Level Feet Base V2,B,S,I,11201,43003,50001,,,,,,,,,Laboratorio de Resbaladicidad SL,,N-T,,1,0,0,£45.00,,GST,,0,1,0,0,0,0,0,45,45,45,45,45,45,0,0,0,0,0,0,0,0,0,0,0,0,0,0,0,0,0,0,0,0,0,0,0,0,N,£21.68,,
WL011,WammaLab Pendulum Bullseye Lvl,B,S,I,11201,43003,50001,,,,,,,,,Laboratorio de Resbaladicidad SL,,N-T,,1,0,0,£60.00,,GST,,0,1,0,0,0,0,0,60,60,60,60,60,60,0,0,0,0,0,0,0,0,0,0,0,0,0,0,0,0,0,0,0,0,0,0,0,0,N,£0.00,,
WL012,WammaLab Levelling Feet Flange,B,S,I,11201,43003,50001,,,,,,,,,Laboratorio de Resbaladicidad SL,,N-T,,1,0,0,£60.00,,GST,,0,1,0,0,0,0,0,60,56,56,56,56,56,0,0,0,0,0,0,0,0,0,0,0,0,0,0,0,0,0,0,0,0,0,0,0,0,N,£0.00,,
WL013,WammaLab Lvl Feet Lock Nut,B,S,I,11201,43003,50001,,,,,,,,,Laboratorio de Resbaladicidad SL,,N-T,,1,0,0,£12.00,,GST,,0,1,0,0,0,0,0,12,12,12,12,12,12,0,0,0,0,0,0,0,0,0,0,0,0,0,0,0,0,0,0,0,0,0,0,0,0,N,£3.97,,
WL014,WammaLab Pendulum Fixing Block,B,S,I,11201,43003,50001,,,,,,,,,Laboratorio de Resbaladicidad SL,,N-T,,1,0,0,£0.00,,GST,,0,1,0,0,0,0,0,0,0,0,0,0,0,0,0,0,0,0,0,0,0,0,0,0,0,0,0,0,0,0,0,0,0,0,0,0,0,N,£86.87,,
WL015,WammaLab Pendulum Hd Lkng Plat,B,S,I,11201,43003,50001,,,,,,,,,Laboratorio de Resbaladicidad SL,,N-T,,1,0,0,£0.00,,GST,,0,1,0,0,0,0,0,0,0,0,0,0,0,0,0,0,0,0,0,0,0,0,0,0,0,0,0,0,0,0,0,0,0,0,0,0,0,N,£0.00,,
WL016,WammaLab Pendulum Hd Lkng Knob,B,S,I,11201,43003,50001,,,,,,,,,Laboratorio de Resbaladicidad SL,,N-T,,1,0,0,£125.00,,GST,,0,1,0,0,0,0,0,125,125,125,125,125,125,0,0,0,0,0,0,0,0,0,0,0,0,0,0,0,0,0,0,0,0,0,0,0,0,N,£0.00,,
WL017,WamaLab Felt Frictn Rings (x2),B,S,I,11201,43003,50001,,,,,,,,,Laboratorio de Resbaladicidad SL,,N-T,,1,0,0,£40.00,,GST,,0,1,0,0,0,0,0,40,20,20,20,20,20,0,0,0,0,0,0,0,0,0,0,0,0,0,0,0,0,0,0,0,0,0,0,0,0,N,£103.19,,
WL018,WammaLab Pointer Counter B Rng,B,S,I,11201,43003,50001,,,,,,,,,Laboratorio de Resbaladicidad SL,,N-T,,1,0,0,£245.00,,GST,,0,1,0,0,0,0,0,245,245,245,245,245,245,0,0,0,0,0,0,0,0,0,0,0,0,0,0,0,0,0,0,0,0,0,0,0,0,N,£89.92,,
WL019,WammaLab Pendulum Head Pivot,B,S,I,11201,43003,50001,,,,,,,,,Laboratorio de Resbaladicidad SL,,N-T,,1,0,0,£400.00,,GST,,0,1,0,0,0,0,0,400,280,280,280,280,280,0,0,0,0,0,0,0,0,0,0,0,0,0,0,0,0,0,0,0,0,0,0,0,0,N,£456.92,,
WL020,WammaLab Pointer Adj Strkr Pla,B,S,I,11201,43003,50001,,,,,,,,,Laboratorio de Resbaladicidad SL,,N-T,,1,0,0,£120.00,,GST,,0,1,0,0,0,0,0,120,120,120,120,120,120,0,0,0,0,0,0,0,0,0,0,0,0,0,0,0,0,0,0,0,0,0,0,0,0,N,£0.00,,
WL021,WammaLab Pendulum Pointer,B,S,I,11201,43003,50001,,,,,,,,,Laboratorio de Resbaladicidad SL,,N-T,,1,0,0,£245.00,,GST,,0,1,0,0,0,0,0,245,150,150,150,150,150,0,0,0,0,0,0,0,0,0,0,0,0,0,0,0,0,0,0,0,0,0,0,0,0,N,£83.50,,
WL022,WammaLab Pendulum Release Ctch,B,S,I,11201,43003,50001,,,,,,,,,Laboratorio de Resbaladicidad SL,,N-T,,1,0,0,£95.00,,GST,,0,1,0,0,0,0,0,95,95,95,95,95,95,0,0,0,0,0,0,0,0,0,0,0,0,0,0,0,0,0,0,0,0,0,0,0,0,N,£0.00,,
WL023,WammaLab Pend Arm Attach Clamp,B,S,I,11201,43003,50001,,,,,,,,,Laboratorio de Resbaladicidad SL,,N-T,,1,0,0,£55.00,,GST,,0,1,0,0,0,0,0,55,55,55,55,55,55,0,0,0,0,0,0,0,0,0,0,0,0,0,0,0,0,0,0,0,0,0,0,0,0,N,£0.00,,
WL024,WammaLab Pendulum Arm Attch Nu,B,S,I,11201,43003,50001,,,,,,,,,Laboratorio de Resbaladicidad SL,,N-T,,1,0,0,£175.00,,GST,,0,1,0,0,0,0,0,175,175,175,175,175,175,0,0,0,0,0,0,0,0,0,0,0,0,0,0,0,0,0,0,0,0,0,0,0,0,N,£0.00,,
WL025,WammaLab Pendulum Rel Plgr Spg,B,S,I,11201,43003,50001,,,,,,,,,Laboratorio de Resbaladicidad SL,,N-T,,1,0,0,£16.00,,GST,,0,1,0,0,0,0,0,16,2.5,2.5,2.5,2.5,2.5,0,0,0,0,0,0,0,0,0,0,0,0,0,0,0,0,0,0,0,0,0,0,0,0,N,£0.00,,
WL026,WammaLab Pendulum Release Plgr,B,S,I,11201,43003,50001,,,,,,,,,Laboratorio de Resbaladicidad SL,,N-T,,1,0,0,£110.00,,GST,,0,1,0,0,0,0,0,110,60,60,60,60,60,0,0,0,0,0,0,0,0,0,0,0,0,0,0,0,0,0,0,0,0,0,0,0,0,N,£0.00,,
WL027,WammaLab Pendulum Release Butt,B,S,I,11201,43003,50001,,,,,,,,,Laboratorio de Resbaladicidad SL,,N-T,,1,0,0,£110.00,,GST,,0,1,0,0,0,0,0,110,110,110,110,110,110,0,0,0,0,0,0,0,0,0,0,0,0,0,0,0,0,0,0,0,0,0,0,0,0,N,£0.00,,
WL028,WammaLab Pendulum Release Bloc,B,S,I,11201,43003,50001,,,,,,,,,Laboratorio de Resbaladicidad SL,,N-T,,1,0,0,£300.00,,GST,,0,1,0,0,0,0,0,300,300,300,300,300,300,0,0,0,0,0,0,0,0,0,0,0,0,0,0,0,0,0,0,0,0,0,0,0,0,N,£0.00,,
WL029,WammaLab Penulum Arm,B,S,I,11201,43003,50001,,,,,,,,,Laboratorio de Resbaladicidad SL,,N-T,,1,0,0,£100.00,,GST,,0,1,0,0,0,0,0,100,100,100,100,100,100,0,0,0,0,0,0,0,0,0,0,0,0,0,0,0,0,0,0,0,0,0,0,0,0,N,£41.32,,
WL030,WammaLab Sprng Tension Assmbly,B,S,I,11201,43003,50001,,,,,,,,,Laboratorio de Resbaladicidad SL,,N-T,,1,0,0,£225.00,,GST,,0,1,0,0,0,0,0,225,175,175,175,175,175,0,0,0,0,0,0,0,0,0,0,0,0,0,0,0,0,0,0,0,0,0,0,0,0,N,£379.78,,
WL031,WammaLab Pend Lift Arm Adj Scr,B,S,I,11201,43003,50001,,,,,,,,,Laboratorio de Resbaladicidad SL,,N-T,,1,0,0,£20.00,,GST,,0,1,0,0,0,0,0,20,20,20,20,20,20,0,0,0,0,0,0,0,0,0,0,0,0,0,0,0,0,0,0,0,0,0,0,0,0,N,£0.00,,
WL032,WammaLab Pendulum Lifting Arm,B,S,I,11201,43003,50001,,,,,,,,,Laboratorio de Resbaladicidad SL,,N-T,,1,0,0,£350.00,,GST,,0,1,0,0,0,0,0,350,350,350,350,350,350,0,0,0,0,0,0,0,0,0,0,0,0,0,0,0,0,0,0,0,0,0,0,0,0,N,£0.00,,
WL033,WammaLab Pend Slid Support Rod,B,S,I,11201,43003,50001,,,,,,,,,Laboratorio de Resbaladicidad SL,,N-T,,1,0,0,£175.00,,GST,,0,1,0,0,0,0,0,175,125,125,125,125,125,0,0,0,0,0,0,0,0,0,0,0,0,0,0,0,0,0,0,0,0,0,0,0,0,N,£0.00,,
WL034,WammaLab Pend Head Bearing (Sm,B,S,I,11201,43003,50001,,,,,,,,,Laboratorio de Resbaladicidad SL,,N-T,,1,0,0,£22.00,,GST,,0,1,0,0,0,0,0,22,22,22,22,22,22,0,0,0,0,0,0,0,0,0,0,0,0,0,0,0,0,0,0,0,0,0,0,0,0,N,£0.00,,
WL035,WammaLab Pendulum Foot Bearin ,B,S,I,11201,43003,50001,,,,,,,,,Laboratorio de Resbaladicidad SL,,N-T,,1,0,0,£10.00,,GST,,0,1,0,0,0,0,0,10,5,5,5,5,5,0,0,0,0,0,0,0,0,0,0,0,0,0,0,0,0,0,0,0,0,0,0,0,0,N,£0.00,,
WL036,WammaLab Pend Head Bearing (Lg,B,S,I,11201,43003,50001,,,,,,,,,Laboratorio de Resbaladicidad SL,,N-T,,1,0,0,£30.00,,GST,,0,1,0,0,0,0,0,30,30,30,30,30,30,0,0,0,0,0,0,0,0,0,0,0,0,0,0,0,0,0,0,0,0,0,0,0,0,N,£0.00,,
WL037,WammaLab Pend Arm Base Block,B,S,I,11201,43003,50001,,,,,,,,,Laboratorio de Resbaladicidad SL,,N-T,,1,0,0,£160.00,,GST,,0,1,0,0,0,0,0,160,140,140,140,140,140,0,0,0,0,0,0,0,0,0,0,0,0,0,0,0,0,0,0,0,0,0,0,0,0,N,£0.00,,
WL038,WammaLab Pendulum Foot Weight,B,S,I,11201,43003,50001,,,,,,,,,Laboratorio de Resbaladicidad SL,,N-T,,1,0,0,£80.00,,GST,,0,1,0,0,0,0,0,80,80,80,80,80,80,0,0,0,0,0,0,0,0,0,0,0,0,0,0,0,0,0,0,0,0,0,0,0,0,N,£0.00,,
WL039,WammaLab Pendulum Foot,B,S,I,11201,43003,50001,,,,,,,,,Laboratorio de Resbaladicidad SL,,N-T,,1,0,0,£430.00,,GST,,0,1,0,0,0,0,0,430,430,430,430,430,430,0,0,0,0,0,0,0,0,0,0,0,0,0,0,0,0,0,0,0,0,0,0,0,0,N,£0.00,,
WL040,WammaLab Pendulum Slider Washe,B,S,I,11201,43003,50001,,,,,,,,,Laboratorio de Resbaladicidad SL,,N-T,,1,0,0,£2.00,,GST,,0,1,0,0,0,0,0,2,0.15,0.15,0.15,0.15,0.15,0,0,0,0,0,0,0,0,0,0,0,0,0,0,0,0,0,0,0,0,0,0,0,0,N,£0.00,,
WL041,WammaLab Pend Slider Humpb Pin,B,S,I,11201,43003,50001,,,,,,,,,Laboratorio de Resbaladicidad SL,,N-T,,1,0,0,£3.00,,GST,,0,1,0,0,0,0,0,3,0.65,0.65,0.65,0.65,0.65,0,0,0,0,0,0,0,0,0,0,0,0,0,0,0,0,0,0,0,0,0,0,0,0,N,£0.00,,
WL042,WammaLab Pendulum Slider Sprin,B,S,I,11201,43003,50001,,,,,,,,,Laboratorio de Resbaladicidad SL,,N-T,,1,0,0,£10.00,,GST,,0,1,0,0,0,0,0,10,30,30,30,30,30,0,0,0,0,0,0,0,0,0,0,0,0,0,0,0,0,0,0,0,0,0,0,0,0,N,£0.00,,
WL043,WammaLab Pendulum Packing Stra,B,S,I,11201,43003,50001,,,,,,,,,Laboratorio de Resbaladicidad SL,,N-T,,1,0,0,£15.00,,GST,,0,1,0,0,0,0,0,15,15,15,15,15,15,0,0,0,0,0,0,0,0,0,0,0,0,0,0,0,0,0,0,0,0,0,0,0,0,N,£0.00,,
WL044,WammaLab Pen Slder Msure Tool ,B,S,I,11201,43003,50001,,,,,,,,,Laboratorio de Resbaladicidad SL,,N-T,,1,0,0,£95.00,,GST,,0,1,0,0,0,0,0,95,35,35,35,35,35,0,0,0,0,0,0,0,0,0,0,0,0,0,0,0,0,0,0,0,0,0,0,0,0,N,£50.38,,
WL045,(Spare) WammaLab Pendulum,B,S,I,11201,43003,50001,,,,,,,,,Laboratorio de Resbaladicidad SL,,N-T,,1,0,0,£0.00,,GST,,0,1,0,0,0,0,0,0,35,35,35,35,35,0,0,0,0,0,0,0,0,0,0,0,0,0,0,0,0,0,0,0,0,0,0,0,0,N,£0.00,,
WL046,WammaLab Pendulum C Spaner,B,S,I,11201,43003,50001,,,,,,,,,Laboratorio de Resbaladicidad SL,,N-T,,1,0,0,£70.00,,GST,,0,1,0,0,0,0,0,70,70,70,70,70,70,0,0,0,0,0,0,0,0,0,0,0,0,0,0,0,0,0,0,0,0,0,0,0,0,N,£0.00,,
WL047,WammaLab Pend Case Brckt (Top),B,S,I,11201,43003,50001,,,,,,,,,Laboratorio de Resbaladicidad SL,,N-T,,1,0,0,£20.00,,GST,,0,1,0,0,0,0,0,20,15,15,15,15,15,0,0,0,0,0,0,0,0,0,0,0,0,0,0,0,0,0,0,0,0,0,0,0,0,N,£0.00,,
WL048,WammaLab Pend Case Brckt (Bot),B,S,I,11201,43003,50001,,,,,,,,,Laboratorio de Resbaladicidad SL,,N-T,,1,0,0,£20.00,,GST,,0,1,0,0,0,0,0,20,15,15,15,15,15,0,0,0,0,0,0,0,0,0,0,0,0,0,0,0,0,0,0,0,0,0,0,0,0,N,£0.00,,
WL049,WammaLab Pendulum Sample Holde,B,S,I,11201,43003,50001,,,,,,,,,Laboratorio de Resbaladicidad SL,,N-T,,1,0,0,£850.00,,GST,,0,1,0,0,0,0,0,850,820,820,820,820,820,0,0,0,0,0,0,0,0,0,0,0,0,0,0,0,0,0,0,0,0,0,0,0,0,N,£450.69,,
WL050,WammaLab Pendulum Flight case,B,S,I,11201,43003,50001,,,,,,,,,Laboratorio de Resbaladicidad SL,,N-T,,1,0,0,"£1,800.00",,GST,,0,1,0,0,0,0,0,1800,1800,1800,1800,1800,1800,0,0,0,0,0,0,0,0,0,0,0,0,0,0,0,0,0,0,0,0,0,0,0,0,N,£16.92,,
WSX009,Wessex Tortus Charger Unit,B,S,I,11201,43003,50001,,,,,,,,,QM Systems Ltd,,N-T,,1,0,0,£295.00,,GST,,0,1,0,0,0,0,0,295,210,210,210,210,210,0,0,0,0,0,0,0,0,0,0,0,0,0,0,0,0,0,0,0,0,0,0,0,0,N,£125.20,,
WSX010,Wessex Tortus Battery Pack,B,S,I,11201,43003,50001,,,,,,,,,QM Systems Ltd,,N-T,,1,0,0,£225.00,,GST,,0,1,0,0,0,0,0,225,225,225,225,225,225,0,0,0,0,0,0,0,0,0,0,0,0,0,0,0,0,0,0,0,0,0,0,0,0,N,£0.00,,
WS007,Wessex Tortus Drive Motor Brac,B,S,I,11201,43003,50001,,,,,,,,,QM Systems Ltd,,N-T,,1,0,0,£42.00,,GST,,0,1,0,0,0,0,0,42,42,42,42,42,42,0,0,0,0,0,0,0,0,0,0,0,0,0,0,0,0,0,0,0,0,0,0,0,0,N,£0.00,,
WS008,Wessex Tortus Drive Motor Gear,B,S,I,11201,43003,50001,,,,,,,,,QM Systems Ltd,,N-T,,1,0,0,£155.00,,GST,,0,1,0,0,0,0,0,155,155,155,155,155,155,0,0,0,0,0,0,0,0,0,0,0,0,0,0,0,0,0,0,0,0,0,0,0,0,N,£0.00,,
WSX008,Wessex Tortus Drive Motor,B,S,I,11201,43003,50001,,,,,,,,,QM Systems Ltd,,N-T,,1,0,0,£355.00,,GST,,0,1,0,0,0,0,0,355,305,305,305,305,305,0,0,0,0,0,0,0,0,0,0,0,0,0,0,0,0,0,0,0,0,0,0,0,0,N,£0.00,,
WS010,Wessex Tortus 2 Printer,B,S,I,11201,43003,50001,,,,,,,,,QM Systems Ltd,,N-T,,1,0,0,£80.00,,GST,,0,1,0,0,0,0,0,80,80,80,80,80,80,0,0,0,0,0,0,0,0,0,0,0,0,0,0,0,0,0,0,0,0,0,0,0,0,N,£0.00,,
WS011,Wessex Tortus Paper Rolls,B,S,I,11201,43003,50001,,,,,,,,,QM Systems Ltd,,N-T,,1,0,0,£6.00,,GST,,0,1,0,0,0,0,0,6,6,6,6,6,6,0,0,0,0,0,0,0,0,0,0,0,0,0,0,0,0,0,0,0,0,0,0,0,0,N,£0.00,,
WS012,Wessex Tortus Paper Roll Spind,B,S,I,11201,43003,50001,,,,,,,,,QM Systems Ltd,,N-T,,1,0,0,£55.00,,GST,,0,1,0,0,0,0,0,55,55,55,55,55,55,0,0,0,0,0,0,0,0,0,0,0,0,0,0,0,0,0,0,0,0,0,0,0,0,N,£0.00,,
WSX005,Wessex Tortus Slider Foot,B,S,I,11201,43003,50001,,,,,,,,,QM Systems Ltd,,N-T,,1,0,0,£180.00,1,GST,,0,1,0,0,0,0,0,180,95,95,95,95,95,0,0,0,0,0,0,0,0,0,0,0,0,0,0,0,0,0,0,0,0,0,0,0,0,N,£0.00,,
WSX004,Wessex Tortus Slider Post,B,S,I,11201,43003,50001,,,,,,,,,QM Systems Ltd,,N-T,,1,0,0,£115.00,,GST,,0,1,0,0,0,0,0,115,90,90,90,90,90,0,0,0,0,0,0,0,0,0,0,0,0,0,0,0,0,0,0,0,0,0,0,0,0,N,£0.00,,
WS015,Wessex Tortus Linear Ball Bear,B,S,I,11201,43003,50001,,,,,,,,,QM Systems Ltd,,N-T,,1,0,0,£50.00,,GST,,0,1,0,0,0,0,0,50,50,50,50,50,50,0,0,0,0,0,0,0,0,0,0,0,0,0,0,0,0,0,0,0,0,0,0,0,0,N,£0.00,,
WS016,Wessex Tortus 2 Optek IR Senso,B,S,I,11201,43003,50001,,,,,,,,,QM Systems Ltd,,N-T,,1,0,0,£3.50,,GST,,0,1,0,0,0,0,0,3.5,3.5,3.5,3.5,3.5,3.5,0,0,0,0,0,0,0,0,0,0,0,0,0,0,0,0,0,0,0,0,0,0,0,0,Y,£0.00,,
WS017,Wessex Tortus 3 Battery Connec,B,S,I,11201,43003,50001,,,,,,,,,QM Systems Ltd,,N-T,,1,0,0,£4.50,,GST,,0,1,0,0,0,0,0,4.5,4.5,4.5,4.5,4.5,4.5,0,0,0,0,0,0,0,0,0,0,0,0,0,0,0,0,0,0,0,0,0,0,0,0,N,£0.00,,
WS018,Wessex Tortus USB Stick,B,S,I,11201,43003,50001,,,,,,,,,QM Systems Ltd,,N-T,,1,0,0,£55.00,,GST,,0,1,0,0,0,0,0,55,55,55,55,55,55,0,0,0,0,0,0,0,0,0,0,0,0,0,0,0,0,0,0,0,0,0,0,0,0,N,£0.00,,
WS019,Wes Tor 3 Lexar USB Stick 2.0,B,S,I,11201,43003,50001,,,,,,,,,QM Systems Ltd,,N-T,,1,0,0,£9.50,,GST,,0,1,0,0,0,0,0,9.5,9.5,9.5,9.5,9.5,9.5,0,0,0,0,0,0,0,0,0,0,0,0,0,0,0,0,0,0,0,0,0,0,0,0,N,£0.00,,
WS020,Wessex Tortus 2 Sensor,B,S,I,11201,43003,50001,,,,,,,,,QM Systems Ltd,,N-T,,1,0,0,£50.00,,GST,,0,1,0,0,0,0,0,50,50,50,50,50,50,0,0,0,0,0,0,0,0,0,0,0,0,0,0,0,0,0,0,0,0,0,0,0,0,Y,£0.00,,
WSX007,Wessex Tortus USB Board,B,S,I,11201,43003,50001,,,,,,,,,QM Systems Ltd,,N-T,,1,0,0,£255.00,,GST,,0,1,0,0,0,0,0,255,250,250,250,250,250,0,0,0,0,0,0,0,0,0,0,0,0,0,0,0,0,0,0,0,0,0,0,0,0,N,£0.00,,
WS022,Wessex Tortus 2 Fuse 2.5amp,B,S,I,11201,43003,50001,,,,,,,,,QM Systems Ltd,,N-T,,1,0,0,£2.00,,GST,,0,1,0,0,0,0,0,2,2,2,2,2,2,0,0,0,0,0,0,0,0,0,0,0,0,0,0,0,0,0,0,0,0,0,0,0,0,Y,£0.00,,
WS023,Wessex Tortus 2 Fuse 6.5amp,B,S,I,11201,43003,50001,,,,,,,,,QM Systems Ltd,,N-T,,1,0,0,£2.00,,GST,,0,1,0,0,0,0,0,2,2,2,2,2,2,0,0,0,0,0,0,0,0,0,0,0,0,0,0,0,0,0,0,0,0,0,0,0,0,Y,£0.00,,
WS024,Tort Slider Conditioning Jig,B,S,I,11201,43003,50001,,,,,,,,,QM Systems Ltd,,N-T,,1,0,0,£45.00,,GST,,0,1,0,0,0,0,0,45,45,45,45,45,45,0,0,0,0,0,0,0,0,0,0,0,0,0,0,0,0,0,0,0,0,0,0,0,0,N,£0.00,,
WSX003,Wessex Tortus Load Cell (Reco),B,S,I,11201,43003,50001,,,,,,,,,QM Systems Ltd,,N-T,,1,0,0,"£1,595.00",,GST,,0,1,0,0,0,0,0,1595,1530,1530,1530,1530,1530,0,0,0,0,0,0,0,0,0,0,0,0,0,0,0,0,0,0,0,0,0,0,0,0,N,£0.00,,
WS026,Wessex Tortus 3 Flight Case,B,S,I,11201,43003,50001,,,,,,,,,QM Systems Ltd,,N-T,,1,0,0,£840.00,,GST,,0,1,0,0,0,0,0,840,840,840,840,840,840,0,0,0,0,0,0,0,0,0,0,0,0,0,0,0,0,0,0,0,0,0,0,0,0,N,£0.00,,
WS027,Pendulum Pointer Arm-MK1,B,S,I,11201,43003,50001,,,,,,,,,QM Systems Ltd,,N-T,,1,0,0,£15.00,,GST,,0,1,0,0,0,0,0,15,15,15,15,15,15,0,0,0,0,0,0,0,0,0,0,0,0,0,0,0,0,0,0,0,0,0,0,0,0,Y,£0.00,,
WS028,Pendulum Pointer Arm-MK2,B,S,I,11201,43003,50001,,,,,,,,,QM Systems Ltd,,N-T,,1,0,0,£185.00,,GST,,0,1,0,0,0,0,0,185,185,185,185,185,185,0,0,0,0,0,0,0,0,0,0,0,0,0,0,0,0,0,0,0,0,0,0,0,0,Y,£0.00,,
WS029,TBC,B,S,I,11201,43003,50001,,,,,,,,,QM Systems Ltd,,N-T,,1,0,0,£5.50,,GST,,0,1,0,0,0,0,0,5.5,5.5,5.5,5.5,5.5,5.5,0,0,0,0,0,0,0,0,0,0,0,0,0,0,0,0,0,0,0,0,0,0,0,0,N,£0.00,,
WS030,Pendulum Pointer Tip - Small,B,S,I,11201,43003,50001,,,,,,,,,QM Systems Ltd,,N-T,,1,0,0,£5.00,,GST,,0,1,0,0,0,0,0,5,5.5,5.5,5.5,5.5,5.5,0,0,0,0,0,0,0,0,0,0,0,0,0,0,0,0,0,0,0,0,0,0,0,0,Y,£0.00,,
WS031,Pendulum Carry Handle Screw Co,B,S,I,11201,43003,50001,,,,,,,,,QM Systems Ltd,,N-T,,1,0,0,£5.00,,GST,,0,1,0,0,0,0,0,5,5,5,5,5,5,0,0,0,0,0,0,0,0,0,0,0,0,0,0,0,0,0,0,0,0,0,0,0,0,N,£0.00,,
WS032,Pend Pointer Counterwright Rin,B,S,I,11201,43003,50001,,,,,,,,,QM Systems Ltd,,N-T,,1,0,0,£200.00,,GST,,0,1,0,0,0,0,0,200,200,200,200,200,200,0,0,0,0,0,0,0,0,0,0,0,0,0,0,0,0,0,0,0,0,0,0,0,0,Y,£0.00,,
WS033,Wessex Tortus Carry Bag,B,S,I,11201,43003,50001,,,,,,,,,QM Systems Ltd,,N-T,,1,0,0,£475.00,,GST,,0,1,0,0,0,0,0,475,475,475,475,475,475,0,0,0,0,0,0,0,0,0,0,0,0,0,0,0,0,0,0,0,0,0,0,0,0,N,£0.00,,
WS034,Wessex Tortus Carry Bag Strap,B,S,I,11201,43003,50001,,,,,,,,,QM Systems Ltd,,N-T,,1,0,0,£85.00,,GST,,0,1,0,0,0,0,0,85,85,85,85,85,85,0,0,0,0,0,0,0,0,0,0,0,0,0,0,0,0,0,0,0,0,0,0,0,0,N,£0.00,,
F001,Mun Pen  Rear Foot Nut,B,S,I,11201,43003,50001,,,,,,,,,Munro Instruments Limited,,N-T,,1,0,0,£4.00,,GST,,0,1,0,0,0,0,0,4,4,4,4,4,4,0,0,0,0,0,0,0,0,0,0,0,0,0,0,0,0,0,0,0,0,0,0,0,0,N,£0.00,,
F002,Mun Pen Slider Lifting Arm Nut,B,S,I,11201,43003,50001,,,,,,,,,Munro Instruments Limited,,N-T,,1,0,0,£4.00,,GST,,0,1,0,0,0,0,0,4,4,4,4,4,4,0,0,0,0,0,0,0,0,0,0,0,0,0,0,0,0,0,0,0,0,0,0,0,0,N,£0.00,,
F003,Mun Pen Slider Washer,B,S,I,11201,43003,50001,,,,,,,,,Munro Instruments Limited,,N-T,,1,0,0,£1.50,,GST,,0,1,0,0,0,0,0,1.5,1.2,1.2,1.2,1.2,1.2,0,0,0,0,0,0,0,0,0,0,0,0,0,0,0,0,0,0,0,0,0,0,0,0,N,£0.00,,
F004,Mun Pen Height Adj Rack Grub S,B,S,I,11201,43003,50001,,,,,,,,,Munro Instruments Limited,,N-T,,1,0,0,£1.20,,GST,,0,1,0,0,0,0,0,1.2,1.2,1.2,1.2,1.2,1.2,0,0,0,0,0,0,0,0,0,0,0,0,0,0,0,0,0,0,0,0,0,0,0,0,N,£0.00,,
F005,M Pen Nylon Nut/Screw Combo-La,B,S,I,11201,43003,50001,,,,,,,,,Munro Instruments Limited,,N-T,,1,0,0,£6.00,,GST,,0,1,0,0,0,0,0,6,6,6,6,6,6,0,0,0,0,0,0,0,0,0,0,0,0,0,0,0,0,0,0,0,0,0,0,0,0,N,£0.00,,
F006,M Pen Nylon Nut/Screw Combo Sm,B,S,I,11201,43003,50001,,,,,,,,,Munro Instruments Limited,,N-T,,1,0,0,£6.00,,GST,,0,1,0,0,0,0,0,6,6,6,6,6,6,0,0,0,0,0,0,0,0,0,0,0,0,0,0,0,0,0,0,0,0,0,0,0,0,N,£0.00,,
F007,M Pendulum Adaptos Dowel F6,B,S,I,11201,43003,50001,,,,,,,,,Munro Instruments Limited,,N-T,,1,0,0,£20.00,,GST,,0,1,0,0,0,0,0,20,20,20,20,20,20,0,0,0,0,0,0,0,0,0,0,0,0,0,0,0,0,0,0,0,0,0,0,0,0,N,£0.00,,
F008,M P Point Bearing Sub-Asse Bol,B,S,I,11201,43003,50001,,,,,,,,,Munro Instruments Limited,,N-T,,,0,0,£0.15,,GST,,0,1,0,0,0,0,0,0.15,0.15,0.15,0.15,0.15,0.15,0,0,0,0,0,0,0,0,0,0,0,0,0,0,0,0,0,0,0,0,0,0,0,0,N,£0.00,,
F009,M P Foot Under Plate Screws,B,S,I,11201,43003,50001,,,,,,,,,Munro Instruments Limited,,N-T,,1,0,0,£1.05,,GST,,0,1,0,0,0,0,0,1.05,1.05,1.05,1.05,1.05,1.05,0,0,0,0,0,0,0,0,0,0,0,0,0,0,0,0,0,0,0,0,0,0,0,0,N,£0.00,,
F010,M P Slider Lifting Arm Cover S,B,S,I,11201,43003,50001,,,,,,,,,Munro Instruments Limited,,N-T,,1,0,0,£1.50,,GST,,0,1,0,0,0,0,0,1.5,1,1,1,1,1,0,0,0,0,0,0,0,0,0,0,0,0,0,0,0,0,0,0,0,0,0,0,0,0,N,£0.00,,
F011,M Pen Frame Locking Bolt,B,S,I,11201,43003,50001,,,,,,,,,Munro Instruments Limited,,N-T,,1,0,0,£1.50,,GST,,0,1,0,0,0,0,0,1.5,1.5,1.5,1.5,1.5,1.5,0,0,0,0,0,0,0,0,0,0,0,0,0,0,0,0,0,0,0,0,0,0,0,0,N,£0.00,,
F012,M Pen Frame Locking Nut,B,S,I,11201,43003,50001,,,,,,,,,Munro Instruments Limited,,N-T,,1,0,0,£1.50,,GST,,0,1,0,0,0,0,0,1.5,1.5,1.5,1.5,1.5,1.5,0,0,0,0,0,0,0,0,0,0,0,0,0,0,0,0,0,0,0,0,0,0,0,0,N,£0.00,,
F013,M P Cup Head Screw 16mm,B,S,I,11201,43003,50001,,,,,,,,,Munro Instruments Limited,,N-T,,1,0,0,£1.50,,GST,,0,1,0,0,0,0,0,1.5,1.5,1.5,1.5,1.5,1.5,0,0,0,0,0,0,0,0,0,0,0,0,0,0,0,0,0,0,0,0,0,0,0,0,N,£0.00,,
F014,M P Cup Head Screw 20mm,B,S,I,11201,43003,50001,,,,,,,,,Munro Instruments Limited,,N-T,,1,0,0,£1.50,,GST,,0,1,0,0,0,0,0,1.5,1.5,1.5,1.5,1.5,1.5,0,0,0,0,0,0,0,0,0,0,0,0,0,0,0,0,0,0,0,0,0,0,0,0,N,£0.00,,
F015,M P Cup Head Screw 25mm,B,S,I,11201,43003,50001,,,,,,,,,Munro Instruments Limited,,N-T,,1,0,0,£1.50,,GST,,0,1,0,0,0,0,0,1.5,1.5,1.5,1.5,1.5,1.5,0,0,0,0,0,0,0,0,0,0,0,0,0,0,0,0,0,0,0,0,0,0,0,0,N,£0.00,,
F016,M P Cup Head Screw 30mm,B,S,I,11201,43003,50001,,,,,,,,,Munro Instruments Limited,,N-T,,1,0,0,£1.50,,GST,,0,1,0,0,0,0,0,1.5,1.5,1.5,1.5,1.5,1.5,0,0,0,0,0,0,0,0,0,0,0,0,0,0,0,0,0,0,0,0,0,0,0,0,N,£0.00,,
F017,WL Pen Sock Head Gr Sc M4x6mm,B,S,I,11201,43003,50001,,,,,,,,,Laboratorio de Resbaladicidad SL,,N-T,,1,0,0,£0.35,,GST,,0,1,0,0,0,0,0,0.35,0.35,0.35,0.35,0.35,0.35,0,0,0,0,0,0,0,0,0,0,0,0,0,0,0,0,0,0,0,0,0,0,0,0,N,£0.00,,
F018,WL Pen Sock Head Gr Sc M5x10mm,B,S,I,11201,43003,50001,,,,,,,,,Laboratorio de Resbaladicidad SL,,N-T,,1,0,0,£1.85,,GST,,0,1,0,0,0,0,0,1.85,1.85,1.85,1.85,1.85,1.85,0,0,0,0,0,0,0,0,0,0,0,0,0,0,0,0,0,0,0,0,0,0,0,0,N,£0.00,,
F019,WL Pendulum 6BA Bolt,B,S,I,11201,43003,50001,,,,,,,,,Laboratorio de Resbaladicidad SL,,N-T,,1,0,0,£0.70,,GST,,0,1,0,0,0,0,0,0.7,0.7,0.7,0.7,0.7,0.7,0,0,0,0,0,0,0,0,0,0,0,0,0,0,0,0,0,0,0,0,0,0,0,0,N,£0.00,,
F020,WL Pen Nylon Screw M6x25mm,B,S,I,11201,43003,50001,,,,,,,,,Laboratorio de Resbaladicidad SL,,N-T,,1,0,0,£1.50,,GST,,0,1,0,0,0,0,0,1.5,1.5,1.5,1.5,1.5,1.5,0,0,0,0,0,0,0,0,0,0,0,0,0,0,0,0,0,0,0,0,0,0,0,0,N,£0.00,,
F021,WL Pen Soc Head Scr M4x10mm SS,B,S,I,11201,43003,50001,,,,,,,,,Laboratorio de Resbaladicidad SL,,N-T,,1,0,0,£4.20,,GST,,0,1,0,0,0,0,0,4.2,4.2,4.2,4.2,4.2,4.2,0,0,0,0,0,0,0,0,0,0,0,0,0,0,0,0,0,0,0,0,0,0,0,0,N,£0.00,,
F022,WL Pen Soc Head Scr M4x5mm SS,B,S,I,11201,43003,50001,,,,,,,,,Laboratorio de Resbaladicidad SL,,N-T,,1,0,0,£4.20,,GST,,0,1,0,0,0,0,0,4.2,4.2,4.2,4.2,4.2,4.2,0,0,0,0,0,0,0,0,0,0,0,0,0,0,0,0,0,0,0,0,0,0,0,0,N,£0.00,,
F023,WL Pen Soc Head Scr M6x15mm,B,S,I,11201,43003,50001,,,,,,,,,Laboratorio de Resbaladicidad SL,,N-T,,1,0,0,£4.20,,GST,,0,1,0,0,0,0,0,4.2,4.2,4.2,4.2,4.2,4.2,0,0,0,0,0,0,0,0,0,0,0,0,0,0,0,0,0,0,0,0,0,0,0,0,N,£0.00,,
F024,WL Pen Soc Head Scr M6x30mm,B,S,I,11201,43003,50001,,,,,,,,,Laboratorio de Resbaladicidad SL,,N-T,,1,0,0,£4.20,,GST,,0,1,0,0,0,0,0,4.2,4.2,4.2,4.2,4.2,4.2,0,0,0,0,0,0,0,0,0,0,0,0,0,0,0,0,0,0,0,0,0,0,0,0,N,£0.00,,
F025,WL Pen Nut M10x30mm,B,S,I,11201,43003,50001,,,,,,,,,Laboratorio de Resbaladicidad SL,,N-T,,1,0,0,£0.70,,GST,,0,1,0,0,0,0,0,0.7,0.7,0.7,0.7,0.7,0.7,0,0,0,0,0,0,0,0,0,0,0,0,0,0,0,0,0,0,0,0,0,0,0,0,N,£0.00,,
F026,WL Pen Flat Washer M10x20mm,B,S,I,11201,43003,50001,,,,,,,,,Laboratorio de Resbaladicidad SL,,N-T,,1,0,0,£0.20,,GST,,0,1,0,0,0,0,0,0.2,0.2,0.2,0.2,0.2,0.2,0,0,0,0,0,0,0,0,0,0,0,0,0,0,0,0,0,0,0,0,0,0,0,0,N,£0.00,,
F027,WL Pen Rear Frame Foot Stud Bo,B,S,I,11201,43003,50001,,,,,,,,,Laboratorio de Resbaladicidad SL,,N-T,,1,0,0,£1.50,,GST,,0,1,0,0,0,0,0,1.5,1.5,1.5,1.5,1.5,1.5,0,0,0,0,0,0,0,0,0,0,0,0,0,0,0,0,0,0,0,0,0,0,0,0,N,£0.00,,
F028,WL Pen Locking Nut M8,B,S,I,11201,43003,50001,,,,,,,,,Laboratorio de Resbaladicidad SL,,N-T,,1,0,0,£5.50,,GST,,0,1,0,0,0,0,0,5.5,5.5,5.5,5.5,5.5,5.5,0,0,0,0,0,0,0,0,0,0,0,0,0,0,0,0,0,0,0,0,0,0,0,0,N,£0.00,,
F029,WL Pen Centre Spindle Locki Nu,B,S,I,11201,43003,50001,,,,,,,,,Laboratorio de Resbaladicidad SL,,N-T,,1,0,0,£4.20,,GST,,0,1,0,0,0,0,0,4.2,4.2,4.2,4.2,4.2,4.2,0,0,0,0,0,0,0,0,0,0,0,0,0,0,0,0,0,0,0,0,0,0,0,0,N,£0.00,,
F030,WL Pen Bullseye Level Screw,B,S,I,11201,43003,50001,,,,,,,,,Laboratorio de Resbaladicidad SL,,N-T,,1,0,0,£1.50,,GST,,0,1,0,0,0,0,0,1.5,1.5,1.5,1.5,1.5,1.5,0,0,0,0,0,0,0,0,0,0,0,0,0,0,0,0,0,0,0,0,0,0,0,0,N,£0.00,,
F031,WS Tortus Printer Bracket Scre,B,S,I,11201,43003,50001,,,,,,,,,QM Systems Ltd,,N-T,,1,0,0,£2.10,,GST,,0,1,0,0,0,0,0,2.1,2.1,2.1,2.1,2.1,2.1,0,0,0,0,0,0,0,0,0,0,0,0,0,0,0,0,0,0,0,0,0,0,0,0,N,£0.00,,
F032,WS Tortus Load Cell Bracket Sc,B,S,I,11201,43003,50001,,,,,,,,,QM Systems Ltd,,N-T,,1,0,0,£4.20,,GST,,0,1,0,0,0,0,0,4.2,4.2,4.2,4.2,4.2,4.2,0,0,0,0,0,0,0,0,0,0,0,0,0,0,0,0,0,0,0,0,0,0,0,0,N,£0.00,,
F033,WS Tortus Case Screw,B,S,I,11201,43003,50001,,,,,,,,,QM Systems Ltd,,N-T,,1,0,0,£1.10,,GST,,0,1,0,0,0,0,0,1.1,1.1,1.1,1.1,1.1,1.1,0,0,0,0,0,0,0,0,0,0,0,0,0,0,0,0,0,0,0,0,0,0,0,0,N,£0.00,,
F034,WS Tortus Foot Ball Spring Plu,B,S,I,11201,43003,50001,,,,,,,,,QM Systems Ltd,,N-T,,1,0,0,£8.50,,GST,,0,1,0,0,0,0,0,8.5,8.5,8.5,8.5,8.5,8.5,0,0,0,0,0,0,0,0,0,0,0,0,0,0,0,0,0,0,0,0,0,0,0,0,N,£0.00,,
F035,WS Tortus Grub Screw M3x3mm,B,S,I,11201,43003,50001,,,,,,,,,QM Systems Ltd,,N-T,,1,0,0,£1.35,,GST,,0,1,0,0,0,0,0,1.35,1.35,1.35,1.35,1.35,1.35,0,0,0,0,0,0,0,0,0,0,0,0,0,0,0,0,0,0,0,0,0,0,0,0,N,£0.00,,
F036,WS Tortus Grub Screw M3x6mm,B,S,I,11201,43003,50001,,,,,,,,,QM Systems Ltd,,N-T,,1,0,0,£1.35,,GST,,0,1,0,0,0,0,0,1.35,1.35,1.35,1.35,1.35,1.35,0,0,0,0,0,0,0,0,0,0,0,0,0,0,0,0,0,0,0,0,0,0,0,0,N,£0.00,,
F037,WS Tortus Pan Head Sc M3x8mm,B,S,I,11201,43003,50001,,,,,,,,,QM Systems Ltd,,N-T,,1,0,0,£1.35,,GST,,0,1,0,0,0,0,0,1.35,1.35,1.35,1.35,1.35,1.35,0,0,0,0,0,0,0,0,0,0,0,0,0,0,0,0,0,0,0,0,0,0,0,0,N,£0.00,,
F038,WS Tort Pan Head Screw M4x10mm,B,S,I,11201,43003,50001,,,,,,,,,QM Systems Ltd,,N-T,,1,0,0,£1.35,,GST,,0,1,0,0,0,0,0,1.35,1.35,1.35,1.35,1.35,1.35,0,0,0,0,0,0,0,0,0,0,0,0,0,0,0,0,0,0,0,0,0,0,0,0,N,£0.00,,
F039,WS Tort Pan Head Screw M4x12mm,B,S,I,11201,43003,50001,,,,,,,,,QM Systems Ltd,,N-T,,,0,0,£1.35,,GST,,0,1,0,0,0,0,0,1.35,1.35,1.35,1.35,1.35,1.35,0,0,0,0,0,0,0,0,0,0,0,0,0,0,0,0,0,0,0,0,0,0,0,0,N,£0.00,,
F040,WS Tortus Nylon Nut M4,B,S,I,11201,43003,50001,,,,,,,,,QM Systems Ltd,,N-T,,1,0,0,£4.55,,GST,,0,1,0,0,0,0,0,4.55,4.55,4.55,4.55,4.55,4.55,0,0,0,0,0,0,0,0,0,0,0,0,0,0,0,0,0,0,0,0,0,0,0,0,N,£0.00,,
F041,Gen Anc Troll Cup Bolt M8x40mm,B,S,I,11201,43003,50001,,,,,,,,,Bunnings Warehouse,,GST,,1,0,0,£0.80,,GST,,0,1,0,0,0,0,0,0.8,0.8,0.8,0.8,0.8,0.8,0,0,0,0,0,0,0,0,0,0,0,0,0,0,0,0,0,0,0,0,0,0,0,0,N,£0.00,,
F042,Gen Anc Troll Cup Nut M8,B,S,I,11201,43003,50001,,,,,,,,,Bunnings Warehouse,,GST,,1,0,0,£0.35,,GST,,0,1,0,0,0,0,0,0.35,0.35,0.35,0.35,0.35,0.35,0,0,0,0,0,0,0,0,0,0,0,0,0,0,0,0,0,0,0,0,0,0,0,0,N,£0.00,,
F043,Gen Anc Troll Cup Washer M8,B,S,I,11201,43003,50001,,,,,,,,,Bunnings Warehouse,,GST,,1,0,0,£1.25,,GST,,0,1,0,0,0,0,0,1.25,1.25,1.25,1.25,1.25,1.25,0,0,0,0,0,0,0,0,0,0,0,0,0,0,0,0,0,0,0,0,0,0,0,0,N,£0.00,,
GA001,Clipboard A4-Dry,B,S,I,11201,43003,50001,,,,,,,,,Office Works,,GST,,1,0,0,£4.95,,GST,,0,1,0,0,0,0,0,4.95,4.95,4.95,4.95,4.95,4.95,0,0,0,0,0,0,0,0,0,0,0,0,0,0,0,0,0,0,0,0,0,0,0,0,N,£0.00,,
GA002,Clipboard -Wet,B,S,I,11201,43003,50001,,,,,,,,,Office Works,,GST,,1,0,0,£4.95,,GST,,0,1,0,0,0,0,0,4.95,4.95,4.95,4.95,4.95,4.95,0,0,0,0,0,0,0,0,0,0,0,0,0,0,0,0,0,0,0,0,0,0,0,0,N,£0.00,,
GA003,Dry Testing Microfibre Cloth,B,S,I,11201,43003,50001,,,,,,,,,Bunnings Warehouse,,GST,,1,0,0,£4.20,,GST,,0,1,0,0,0,0,0,4.2,4.2,4.2,4.2,4.2,4.2,0,0,0,0,0,0,0,0,0,0,0,0,0,0,0,0,0,0,0,0,0,0,0,0,N,£0.00,,
GA004,Doorstop,B,S,I,11201,43003,50001,,,,,,,,,Bunnings Warehouse,,GST,,1,0,0,£1.60,,GST,,0,1,0,0,0,0,0,1.6,1.6,1.6,1.6,1.6,1.6,0,0,0,0,0,0,0,0,0,0,0,0,0,0,0,0,0,0,0,0,0,0,0,0,N,£0.00,,
GA006,Onsite Testing Ruler 15cm SS,B,S,I,11201,43003,50001,,,,,,,,,Office Works,,GST,,1,0,0,£6.00,,GST,,0,1,0,0,0,0,0,6,6,6,6,6,6,0,0,0,0,0,0,0,0,0,0,0,0,0,0,0,0,0,0,0,0,0,0,0,0,N,£4.27,,
GA007,Trolly Base Cups-Small,B,S,I,11201,43003,50001,,,,,,,,,,,GST,,1,0,0,£2.80,,GST,,0,1,0,0,0,0,0,2.8,2.8,2.8,2.8,2.8,2.8,0,0,0,0,0,0,0,0,0,0,0,0,0,0,0,0,0,0,0,0,0,0,0,0,N,£0.00,,
GA008,Trolly Base Cups - Large,B,S,I,11201,43003,50001,,,,,,,,,,,GST,,1,0,0,£3.80,,GST,,0,1,0,0,0,0,0,3.8,3.8,3.8,3.8,3.8,3.8,0,0,0,0,0,0,0,0,0,0,0,0,0,0,0,0,0,0,0,0,0,0,0,0,N,£0.00,,
GA009,Safety - Gear Bag,B,S,I,11201,43003,50001,,,,,,,,,,,GST,,1,0,0,£20.00,,GST,,0,1,0,0,0,0,0,20,20,20,20,20,20,0,0,0,0,0,0,0,0,0,0,0,0,0,0,0,0,0,0,0,0,0,0,0,0,N,£0.00,,
GA010,Safety - Hard Hat,B,S,I,11201,43003,50001,,,,,,,,,Office Works,,GST,,1,0,0,£15.00,,GST,,0,1,0,0,0,0,0,15,15,15,15,15,15,0,0,0,0,0,0,0,0,0,0,0,0,0,0,0,0,0,0,0,0,0,0,0,0,N,£0.00,,
GA012,Safety - Glove Keeper,B,S,I,11201,43003,50001,,,,,,,,,,,GST,,1,0,0,£4.20,,GST,,0,1,0,0,0,0,0,4.2,4.2,4.2,4.2,4.2,4.2,0,0,0,0,0,0,0,0,0,0,0,0,0,0,0,0,0,0,0,0,0,0,0,0,N,£0.00,,
GA011,Safety- Hi Vist Vest ,B,S,I,11201,43003,50001,,,,,,,,,,,GST,,1,0,0,£10.00,,GST,,0,1,0,0,0,0,0,10,10,10,10,10,10,0,0,0,0,0,0,0,0,0,0,0,0,0,0,0,0,0,0,0,0,0,0,0,0,N,£0.00,,
GA013,Safety - Gloves,B,S,I,11201,43003,50001,,,,,,,,,,,GST,,1,0,0,£6.95,,GST,,0,1,0,0,0,0,0,6.95,6.95,6.95,6.95,6.95,6.95,0,0,0,0,0,0,0,0,0,0,0,0,0,0,0,0,0,0,0,0,0,0,0,0,N,£0.00,,
GA014,Safety- Glasses,B,S,I,11201,43003,50001,,,,,,,,,,,GST,,1,0,0,£4.00,,GST,,0,1,0,0,0,0,0,4,4,4,4,4,4,0,0,0,0,0,0,0,0,0,0,0,0,0,0,0,0,0,0,0,0,0,0,0,0,N,£0.00,,
GA015,Safety- Traffic Cones,B,S,I,11201,43003,50001,,,,,,,,,,,GST,,1,0,0,£20.00,,GST,,0,1,0,0,0,0,0,20,20,20,20,20,20,0,0,0,0,0,0,0,0,0,0,0,0,0,0,0,0,0,0,0,0,0,0,0,0,N,£0.00,,
GA016,"Safety-Traffic Cones ""Keep Ou ",B,S,I,11201,43003,50001,,,,,,,,,,,GST,,1,0,0,£13.50,,GST,,0,1,0,0,0,0,0,13.5,13.5,13.5,13.5,13.5,13.5,0,0,0,0,0,0,0,0,0,0,0,0,0,0,0,0,0,0,0,0,0,0,0,0,N,£0.00,,
GA017,Dry Testing Ancillary Kit Stra,B,S,I,11201,43003,50001,,,,,,,,,,,GST,,1,0,0,£13.85,,GST,,0,1,0,0,0,0,0,13.85,13.85,13.85,13.85,13.85,13.85,0,0,0,0,0,0,0,0,0,0,0,0,0,0,0,0,0,0,0,0,0,0,0,0,N,£0.00,,
GA005,Digital Site Thermometer,B,S,I,11201,43003,50001,,,,,,,,,,,GST,,1,0,0,£15.00,,GST,,0,1,0,0,0,0,0,15,15,15,15,15,15,0,0,0,0,0,0,0,0,0,0,0,0,0,0,0,0,0,0,0,0,0,0,0,0,N,£9.46,,
GA018,Conditioning Board Plate,B,S,I,11201,43003,50001,,,,,,,,,,,GST,,1,0,0,£15.00,,GST,,0,1,0,0,0,0,0,15,15,15,15,15,15,0,0,0,0,0,0,0,0,0,0,0,0,0,0,0,0,0,0,0,0,0,0,0,0,N,£0.00,,
GA019,Conditioning Board Feet,B,S,I,11201,43003,50001,,,,,,,,,,,GST,,1,0,0,£2.30,,GST,,0,1,0,0,0,0,0,2.3,2.3,2.3,2.3,2.3,2.3,0,0,0,0,0,0,0,0,0,0,0,0,0,0,0,0,0,0,0,0,0,0,0,0,N,£0.00,,
GA020,Flat Bed Trolley,B,S,I,11201,43003,50001,,,,,,,,,,,GST,,1,0,0,£65.00,,GST,,0,1,0,0,0,0,0,65,65,65,65,65,65,0,0,0,0,0,0,0,0,0,0,0,0,0,0,0,0,0,0,0,0,0,0,0,0,N,£0.00,,
GA021,Wet Ancillary Hard Case,B,S,I,11201,43003,50001,,,,,,,,,,,GST,,1,0,0,£265.00,,GST,,0,1,0,0,0,0,0,265,265,265,265,265,265,0,0,0,0,0,0,0,0,0,0,0,0,0,0,0,0,0,0,0,0,0,0,0,0,N,£199.55,,
GA022,Wet Floor Sign,B,S,I,11201,43003,50001,,,,,,,,,,,GST,,1,0,0,£16.65,,GST,,0,1,0,0,0,0,0,16.65,16.65,16.65,16.65,16.65,16.65,0,0,0,0,0,0,0,0,0,0,0,0,0,0,0,0,0,0,0,0,0,0,0,0,N,£0.00,,
GA023,Digital Site Level,B,S,I,11201,43003,50001,,,,,,,,,,,GST,,1,0,0,£250.00,,GST,,0,1,0,0,0,0,0,250,250,250,250,250,250,0,0,0,0,0,0,0,0,0,0,0,0,0,0,0,0,0,0,0,0,0,0,0,0,N,£0.00,,
GA024,Telescopic Mop Handle,B,S,I,11201,43003,50001,,,,,,,,,,,GST,,1,0,0,£14.00,,GST,,0,1,0,0,0,0,0,14,14,14,14,14,14,0,0,0,0,0,0,0,0,0,0,0,0,0,0,0,0,0,0,0,0,0,0,0,0,N,£9.80,,
GA025,Blue Mop Head,B,S,I,11201,43003,50001,,,,,,,,,,,GST,,1,0,0,£22.00,,GST,,0,1,0,0,0,0,0,22,22,22,22,22,22,0,0,0,0,0,0,0,0,0,0,0,0,0,0,0,0,0,0,0,0,0,0,0,0,N,£16.67,,
GA026,Spray Bottle,B,S,I,11201,43003,50001,,,,,,,,,Bunnings Warehouse,,GST,,1,0,0,£4.55,,GST,,0,1,0,0,0,0,0,4.55,4.55,4.55,4.55,4.55,4.55,0,0,0,0,0,0,0,0,0,0,0,0,0,0,0,0,0,0,0,0,0,0,0,0,N,£0.00,,
GA027,Testing Tool,B,S,I,11201,43003,50001,,,,,,,,,Bunnings Warehouse,,GST,,1,0,0,£20.00,,GST,,0,1,0,0,0,0,0,20,20,20,20,20,20,0,0,0,0,0,0,0,0,0,0,0,0,0,0,0,0,0,0,0,0,0,0,0,0,N,£0.00,,
GA028,Pendulum Step Testing Stand,B,S,I,11201,43003,50001,,,,,,,,,,,GST,,1,0,0,£230.00,,GST,,0,1,0,0,0,0,0,230,125,125,125,125,125,0,0,0,0,0,0,0,0,0,0,0,0,0,0,0,0,0,0,0,0,0,0,0,0,N,£0.00,,
GA029,Trolley Storage Box,B,S,I,11201,43003,50001,,,,,,,,,,,GST,,1,0,0,£320.00,,GST,,0,1,0,0,0,0,0,320,320,320,320,320,320,0,0,0,0,0,0,0,0,0,0,0,0,0,0,0,0,0,0,0,0,0,0,0,0,N,£0.00,,
TC001,Slider 96 (4S) Rubber Sliders,B,S,I,11201,43003,50001,,,,,,,,,Smithers MSE Limited,,N-T,,1,0,0,£115.00,,GST,,0,1,0,0,0,0,0,115,95,95,95,95,95,0,0,0,0,0,0,0,0,0,0,0,0,0,0,0,0,0,0,0,0,0,0,0,0,N,£63.11,,
TC002,Slider 55 (TRL) Rubber Slider,B,S,I,11201,43003,50001,,,,,,,,,Smithers MSE Limited,,N-T,,1,0,0,£115.00,,GST,,0,1,0,0,0,0,0,115,95,95,95,95,95,0,0,0,0,0,0,0,0,0,0,0,0,0,0,0,0,0,0,0,0,0,0,0,0,N,£63.11,,
TC003,Tortus Slider (Pack of 6),B,S,I,11201,43003,50001,,,,,,,,,,,GST,,1,0,0,£130.00,,GST,,0,1,0,0,0,0,0,130,100,100,100,100,100,0,0,0,0,0,0,0,0,0,0,0,0,0,0,0,0,0,0,0,0,0,0,0,0,N,£0.00,,
TC004,Slider Backing Plate,B,S,I,11201,43003,50001,,,,,,,,,,,GST,,1,0,0,£45.00,,GST,,0,1,0,0,0,0,0,45,35,35,35,35,35,0,0,0,0,0,0,0,0,0,0,0,0,0,0,0,0,0,0,0,0,0,0,0,0,N,£11.81,,
TC005,Verif -P400 Paper(Pack of 10),B,S,I,11201,43003,50001,,,,,,,,,Smithers MSE Limited,,GST,,1,0,0,£20.00,,GST,,0,1,0,0,0,0,0,20,20,20,20,20,20,0,0,0,0,0,0,0,0,0,0,0,0,0,0,0,0,0,0,0,0,0,0,0,0,N,£0.00,,
TC006,Verif- 3M Pink Lap Film (P 10 ,B,S,I,11201,43003,50001,,,,,,,,,RS Components Pty Ltd,,GST,,1,0,0,£55.00,,GST,,0,1,0,0,0,0,0,55,50,50,50,50,50,0,0,0,0,0,0,0,0,0,0,0,0,0,0,0,0,0,0,0,0,0,0,0,0,N,£29.17,,
TC007,Verif- #60 Grit Pap (P of 10),B,S,I,11201,43003,50001,,,,,,,,,,,GST,,1,0,0,£20.00,,GST,,0,1,0,0,0,0,0,20,20,20,20,20,20,0,0,0,0,0,0,0,0,0,0,0,0,0,0,0,0,0,0,0,0,0,0,0,0,N,£0.00,,
TC008,Verif- 3M Green Lap Film (P 10,B,S,I,11201,43003,50001,,,,,,,,,,,GST,,1,0,0,£0.00,,GST,,0,1,0,0,0,0,0,0,0,0,0,0,0,0,0,0,0,0,0,0,0,0,0,0,0,0,0,0,0,0,0,0,0,0,0,0,0,N,£0.00,,
TC009,Verif-WL Float Glass,B,S,I,11201,43003,50001,,,,,,,,,Laboratorio de Resbaladicidad SL,,N-T,,1,0,0,£40.00,,GST,,0,1,0,0,0,0,0,40,40,40,40,40,40,0,0,0,0,0,0,0,0,0,0,0,0,0,0,0,0,0,0,0,0,0,0,0,0,N,£23.75,,
TC010,Verif WL Pavigress Tile,B,S,I,11201,43003,50001,,,,,,,,,Laboratorio de Resbaladicidad SL,,N-T,,1,0,0,£230.00,,GST,,0,1,0,0,0,0,0,230,230,230,230,230,230,0,0,0,0,0,0,0,0,0,0,0,0,0,0,0,0,0,0,0,0,0,0,0,0,N,£135.47,,
TC011,Verif- Munro Float Glass,B,S,I,11201,43003,50001,,,,,,,,,Munro Instruments Limited,,N-T,,1,0,0,£175.00,,GST,,0,1,0,0,0,0,0,175,175,175,175,175,175,0,0,0,0,0,0,0,0,0,0,0,0,0,0,0,0,0,0,0,0,0,0,0,0,N,£0.00,,
TC012,Verification- Munto Pavigres T,B,S,I,11201,43003,50001,,,,,,,,,Munro Instruments Limited,,N-T,,1,0,0,£190.00,,GST,,0,1,0,0,0,0,0,190,190,190,190,190,190,0,0,0,0,0,0,0,0,0,0,0,0,0,0,0,0,0,0,0,0,0,0,0,0,Y,£0.00,,
B001,Pendulum Trolley,B,S,I,11201,43003,50001,,,,,,,,,,,GST,,1,0,3,£125.00,,GST,,0,1,0,0,0,0,0,125,125,125,125,125,125,0,0,0,0,0,0,0,0,0,0,0,0,0,0,0,0,0,0,0,0,0,0,0,0,N,£0.00,,
B002,Pendulum Onsite Testing Pack,B,S,I,11201,43003,50001,,,,,,,,,,,GST,,1,0,5,"£1,450.00",,GST,,0,1,0,0,0,0,0,1450,1450,1450,1450,1450,1450,0,0,0,0,0,0,0,0,0,0,0,0,0,0,0,0,0,0,0,0,0,0,0,0,N,£0.00,,
B003,WL Pendulum Verification Kit,B,S,I,11201,43003,50001,,,,,,,,,Laboratorio de Resbaladicidad SL,,N-T,,1,0,5,"£1,450.00",,GST,,0,1,0,0,0,0,0,1450,1450,1450,1450,1450,1450,0,0,0,0,0,0,0,0,0,0,0,0,0,0,0,0,0,0,0,0,0,0,0,0,N,£0.00,,
B004,Munro Pendulum Verification Ki,B,S,I,11201,43003,50001,,,,,,,,,Munro Instruments Limited,,N-T,,1,0,5,"£1,250.00",,GST,,0,1,0,0,0,0,0,1250,1250,1250,1250,1250,1250,0,0,0,0,0,0,0,0,0,0,0,0,0,0,0,0,0,0,0,0,0,0,0,0,Y,£0.00,,
B005,Wessex Tortus Verif Kit,B,S,I,11201,43003,50001,,,,,,,,,QM Systems Ltd,,N-T,,1,0,1,£450.00,,GST,,0,1,0,0,0,0,0,450,325,325,325,325,325,0,0,0,0,0,0,0,0,0,0,0,0,0,0,0,0,0,0,0,0,0,0,0,0,N,£0.00,,
B006,Wessex Tort Onsite Testing Pac,B,S,I,11201,43003,50001,,,,,,,,,QM Systems Ltd,,N-T,,1,0,5,£350.00,,GST,,0,1,0,0,0,0,0,350,250,250,250,250,250,0,0,0,0,0,0,0,0,0,0,0,0,0,0,0,0,0,0,0,0,0,0,0,0,N,£0.00,,
B007,Pendulum Conditoning Board,B,S,I,11201,43003,50001,,,,,,,,,,,GST,,1,0,5,£95.00,,GST,,0,1,0,0,0,0,0,95,95,95,95,95,95,0,0,0,0,0,0,0,0,0,0,0,0,0,0,0,0,0,0,0,0,0,0,0,0,N,£0.00,,
B008,Pend Conditioning Board-Inhous,B,S,I,11201,43003,50001,,,,,,,,,,,GST,,1,0,5,£115.00,,GST,,0,1,0,0,0,0,0,115,115,115,115,115,115,0,0,0,0,0,0,0,0,0,0,0,0,0,0,0,0,0,0,0,0,0,0,0,0,N,£0.00,,
B009,ISTS- Wet Floor Sign,B,S,I,11201,43003,50001,,,,,,,,,QM Systems Ltd,,GST,,1,0,5,£40.00,,GST,,0,1,0,0,0,0,0,40,40,40,40,40,40,0,0,0,0,0,0,0,0,0,0,0,0,0,0,0,0,0,0,0,0,0,0,0,0,N,£0.00,,
WC001,Superglue- Powerflex Gel Contr,B,S,I,11201,43003,50001,,,,,,,,,,,GST,,1,0,0,£0.00,,GST,,0,1,0,0,0,0,0,0,0,0,0,0,0,0,0,0,0,0,0,0,0,0,0,0,0,0,0,0,0,0,0,0,0,0,0,0,0,N,£0.00,,
WC002,Packaging- Scotch Tape,B,S,I,11201,43003,50001,,,,,,,,,,,GST,,1,0,0,£0.00,,GST,,0,1,0,0,0,0,0,0,0,0,0,0,0,0,0,0,0,0,0,0,0,0,0,0,0,0,0,0,0,0,0,0,0,0,0,0,0,N,£0.00,,
WC003,Packaging- Clear Pallet Wrap,B,S,I,11201,43003,50001,,,,,,,,,,,GST,,1,0,0,£0.00,,GST,,0,1,0,0,0,0,0,0,0,0,0,0,0,0,0,0,0,0,0,0,0,0,0,0,0,0,0,0,0,0,0,0,0,0,0,0,0,N,£0.00,,
WC004,Packaging- Cardboard Roll,B,S,I,11201,43003,50001,,,,,,,,,,,GST,,1,0,0,£0.00,,GST,,0,1,0,0,0,0,0,0,0,0,0,0,0,0,0,0,0,0,0,0,0,0,0,0,0,0,0,0,0,0,0,0,0,0,0,0,0,N,£0.00,,
WC005,Packaging- Bubble Wrap,B,S,I,11201,43003,50001,,,,,,,,,,,GST,,1,0,0,£0.00,,GST,,0,1,0,0,0,0,0,0,0,0,0,0,0,0,0,0,0,0,0,0,0,0,0,0,0,0,0,0,0,0,0,0,0,0,0,0,0,N,£0.00,,
WC007,Pack-Med Snap Lock Bag75X100,B,S,I,11201,43003,50001,,,,,,,,,,,GST,,1,0,0,£0.00,,GST,,0,1,0,0,0,0,0,0,0,0,0,0,0,0,0,0,0,0,0,0,0,0,0,0,0,0,0,0,0,0,0,0,0,0,0,0,0,N,£0.00,,
WC006,Pack-Small Snap Lock Bag40x50M,B,S,I,11201,43003,50001,,,,,,,,,,,GST,,1,0,0,£0.00,,GST,,0,1,0,0,0,0,0,0,0,0,0,0,0,0,0,0,0,0,0,0,0,0,0,0,0,0,0,0,0,0,0,0,0,0,0,0,0,N,£0.00,,
WC008,Pack-L  Snap Lock Bag100x155mm,B,S,I,11201,43003,50001,,,,,,,,,,,GST,,1,0,0,£0.00,,GST,,0,1,0,0,0,0,0,0,0,0,0,0,0,0,0,0,0,0,0,0,0,0,0,0,0,0,0,0,0,0,0,0,0,0,0,0,0,N,£0.00,,
WC009,Pack-XL  Snap Lock Bag A4,B,S,I,11201,43003,50001,,,,,,,,,,,GST,,1,0,0,£0.00,,GST,,0,1,0,0,0,0,0,0,0,0,0,0,0,0,0,0,0,0,0,0,0,0,0,0,0,0,0,0,0,0,0,0,0,0,0,0,0,N,£0.00,,
WC010,Pack-S Padded Satchel125x160mm,B,S,I,11201,43003,50001,,,,,,,,,,,GST,,1,0,0,£0.00,,GST,,0,1,0,0,0,0,0,0,0,0,0,0,0,0,0,0,0,0,0,0,0,0,0,0,0,0,0,0,0,0,0,0,0,0,0,0,0,N,£0.00,,
WC011,Pack-M Padded Satchel151x229mm,B,S,I,11201,43003,50001,,,,,,,,,,,GST,,1,0,0,£0.00,,GST,,0,1,0,0,0,0,0,0,0,0,0,0,0,0,0,0,0,0,0,0,0,0,0,0,0,0,0,0,0,0,0,0,0,0,0,0,0,N,£0.00,,
WC012,Pack-L Padded Satchel265x380mm,B,S,I,11201,43003,50001,,,,,,,,,,,GST,,1,0,0,£0.00,,GST,,0,1,0,0,0,0,0,0,0,0,0,0,0,0,0,0,0,0,0,0,0,0,0,0,0,0,0,0,0,0,0,0,0,0,0,0,0,N,£0.00,,
WC013,Pack-XL Tough Bag 400x659mm,B,S,I,11201,43003,50001,,,,,,,,,,,GST,,1,0,0,£0.00,,GST,,0,1,0,0,0,0,0,0,0,0,0,0,0,0,0,0,0,0,0,0,0,0,0,0,0,0,0,0,0,0,0,0,0,0,0,0,0,N,£0.00,,
WC014,Microfibre Clean Cloth- Multic,B,S,I,11201,43003,50001,,,,,,,,,,,GST,,1,0,0,£0.00,,GST,,0,1,0,0,0,0,0,0,0,0,0,0,0,0,0,0,0,0,0,0,0,0,0,0,0,0,0,0,0,0,0,0,0,0,0,0,0,N,£0.00,,
WC015,Microfibre Cleaning Cloth-Blue,B,S,I,11201,43003,50001,,,,,,,,,,,GST,,1,0,0,£0.00,,GST,,0,1,0,0,0,0,0,0,0,0,0,0,0,0,0,0,0,0,0,0,0,0,0,0,0,0,0,0,0,0,0,0,0,0,0,0,0,N,£0.00,,
WC016,Black Spray Paint,B,S,I,11201,43003,50001,,,,,,,,,,,GST,,1,0,0,£0.00,,GST,,0,1,0,0,0,0,0,0,0,0,0,0,0,0,0,0,0,0,0,0,0,0,0,0,0,0,0,0,0,0,0,0,0,0,0,0,0,Y,£0.00,,
WC017,Loc-Tite,B,S,I,11201,43003,50001,,,,,,,,,,,GST,,1,0,0,£0.00,,GST,,0,1,0,0,0,0,0,0,0,0,0,0,0,0,0,0,0,0,0,0,0,0,0,0,0,0,0,0,0,0,0,0,0,0,0,0,0,Y,£0.00,,
WC018,Graphite Powder,B,S,I,11201,43003,50001,,,,,,,,,,,GST,,1,0,0,£0.00,,GST,,0,1,0,0,0,0,0,0,0,0,0,0,0,0,0,0,0,0,0,0,0,0,0,0,0,0,0,0,0,0,0,0,0,0,0,0,0,N,£0.00,,
WC019,Methylated Spirits-1L,B,S,I,11201,43003,50001,,,,,,,,,,,GST,,1,0,0,£0.00,,GST,,0,1,0,0,0,0,0,0,0,0,0,0,0,0,0,0,0,0,0,0,0,0,0,0,0,0,0,0,0,0,0,0,0,0,0,0,0,N,£0.00,,
WC020,Turpentine-1L,B,S,I,11201,43003,50001,,,,,,,,,,,GST,,1,0,0,£0.00,,GST,,0,1,0,0,0,0,0,0,0,0,0,0,0,0,0,0,0,0,0,0,0,0,0,0,0,0,0,0,0,0,0,0,0,0,0,0,0,N,£0.00,,
WC021,WD10-275G,B,S,I,11201,43003,50001,,,,,,,,,,,GST,,1,0,0,£0.00,,GST,,0,1,0,0,0,0,0,0,0,0,0,0,0,0,0,0,0,0,0,0,0,0,0,0,0,0,0,0,0,0,0,0,0,0,0,0,0,N,£0.00,,
WC022,Nevr-Dull Wadding Polish,B,S,I,11201,43003,50001,,,,,,,,,,,GST,,1,0,0,£0.00,,GST,,0,1,0,0,0,0,0,0,0,0,0,0,0,0,0,0,0,0,0,0,0,0,0,0,0,0,0,0,0,0,0,0,0,0,0,0,0,N,£28.41,,
WC023,Ajax Spray & Wipe,B,S,I,11201,43003,50001,,,,,,,,,,,GST,,1,0,0,£0.00,,GST,,0,1,0,0,0,0,0,0,0,0,0,0,0,0,0,0,0,0,0,0,0,0,0,0,0,0,0,0,0,0,0,0,0,0,0,0,0,N,£0.00,,
WC024,Spray Glue,B,S,I,11201,43003,50001,,,,,,,,,,,GST,,1,0,0,£0.00,,GST,,0,1,0,0,0,0,0,0,0,0,0,0,0,0,0,0,0,0,0,0,0,0,0,0,0,0,0,0,0,0,0,0,0,0,0,0,0,N,£0.00,,
WC025,Demineralised Water -5L,B,S,I,11201,43003,50001,,,,,,,,,,,GST,,1,0,0,£0.00,,GST,,0,1,0,0,0,0,0,0,0,0,0,0,0,0,0,0,0,0,0,0,0,0,0,0,0,0,0,0,0,0,0,0,0,0,0,0,0,N,£0.00,,
WC026,Administration Archive Box,B,S,I,11201,43003,50001,,,,,,,,,,,GST,,1,0,0,£0.00,,GST,,0,1,0,0,0,0,0,0,0,0,0,0,0,0,0,0,0,0,0,0,0,0,0,0,0,0,0,0,0,0,0,0,0,0,0,0,0,N,£11.77,,
P001,Calibration Plate (AU) Pendulu,B,S,I,11201,43003,50001,,,,,,,,,,,GST,,1,0,0,£0.00,,GST,,0,1,0,0,0,0,0,0,0,0,0,0,0,0,0,0,0,0,0,0,0,0,0,0,0,0,0,0,0,0,0,0,0,0,0,0,0,N,£7.50,,
P002,Calibration Temp Label- Pendul,B,S,I,11201,43003,50001,,,,,,,,,,,GST,,1,0,0,£0.00,,GST,,0,1,0,0,0,0,0,0,0,0,0,0,0,0,0,0,0,0,0,0,0,0,0,0,0,0,0,0,0,0,0,0,0,0,0,0,0,N,£0.00,,
P003,Calibration Label-Tortus,B,S,I,11201,43003,50001,,,,,,,,,,,GST,,1,0,0,£0.00,,GST,,0,1,0,0,0,0,0,0,0,0,0,0,0,0,0,0,0,0,0,0,0,0,0,0,0,0,0,0,0,0,0,0,0,0,0,0,0,N,£0.00,,
P004,Calibration Plata (NZ)-Pendulu,B,S,I,11201,43003,50001,,,,,,,,,,,GST,,1,0,0,£0.00,,GST,,0,1,0,0,0,0,0,0,0,0,0,0,0,0,0,0,0,0,0,0,0,0,0,0,0,0,0,0,0,0,0,0,0,0,0,0,0,Y,£0.00,,
P005,Sticker-GES (Small),B,S,I,11201,43003,50001,,,,,,,,,,,GST,,1,0,0,£0.00,,GST,,0,1,0,0,0,0,0,0,0,0,0,0,0,0,0,0,0,0,0,0,0,0,0,0,0,0,0,0,0,0,0,0,0,0,0,0,0,N,£0.20,,
P006,Sticker-Instr Calib (Small),B,S,I,11201,43003,50001,,,,,,,,,,,GST,,1,0,0,£0.00,,GST,,0,1,0,0,0,0,0,0,0,0,0,0,0,0,0,0,0,0,0,0,0,0,0,0,0,0,0,0,0,0,0,0,0,0,0,0,0,N,£0.21,,
P007,Sticker-General Equpiment,B,S,I,11201,43003,50001,,,,,,,,,,,GST,,1,0,0,£0.00,,GST,,0,1,0,0,0,0,0,0,0,0,0,0,0,0,0,0,0,0,0,0,0,0,0,0,0,0,0,0,0,0,0,0,0,0,0,0,0,N,£1.10,,
P008,Sticker-Oval (ISTS),B,S,I,11201,43003,50001,,,,,,,,,,,GST,,1,0,0,£0.00,,GST,,0,1,0,0,0,0,0,0,0,0,0,0,0,0,0,0,0,0,0,0,0,0,0,0,0,0,0,0,0,0,0,0,0,0,0,0,0,N,£0.00,,
P009,Sticker- Wet Floor Sign,B,S,I,11201,43003,50001,,,,,,,,,,,GST,,1,0,0,£0.00,,GST,,0,1,0,0,0,0,0,0,0,0,0,0,0,0,0,0,0,0,0,0,0,0,0,0,0,0,0,0,0,0,0,0,0,0,0,0,0,N,£12.31,,
P010,Sticker - Trolley Box,B,S,I,11201,43003,50001,,,,,,,,,,,GST,,1,0,0,£0.00,,GST,,0,1,0,0,0,0,0,0,0,0,0,0,0,0,0,0,0,0,0,0,0,0,0,0,0,0,0,0,0,0,0,0,0,0,0,0,0,N,£22.95,,
P011,Sticker-GPC Sample,B,S,I,11201,43003,50001,,,,,,,,,,,GST,,1,0,0,£0.00,,GST,,0,1,0,0,0,0,0,0,0,0,0,0,0,0,0,0,0,0,0,0,0,0,0,0,0,0,0,0,0,0,0,0,0,0,0,0,0,N,£0.00,,
P012,"GES-""With Compliments""Card",B,S,I,11201,43003,50001,,,,,,,,,,,GST,,1,0,0,£0.00,,GST,,0,1,0,0,0,0,0,0,0,0,0,0,0,0,0,0,0,0,0,0,0,0,0,0,0,0,0,0,0,0,0,0,0,0,0,0,0,N,£0.00,,
IC001,Calibration Pendulum,,S,,,43003,,,,,,,,,,,,,,,,,"£1,475.00",1,GST,,0,1,0,0,0,0,0,1475,3.5,3.5,3.5,3.5,3.5,0,0,0,0,0,0,0,0,0,0,0,0,0,0,0,0,0,0,0,0,0,0,0,0,N,,,
IC002,Control testing-Pendulum,,S,,,43003,,,,,,,,,,,,,,,,,£500.00,1,GST,,0,1,0,0,0,0,0,500,1175,1175,1175,1175,1175,0,0,0,0,0,0,0,0,0,0,0,0,0,0,0,0,0,0,0,0,0,0,0,0,N,,,
IC003,Equipment Repair- Labour (1hr),,S,,,43003,,,,,,,,,,,,,,,,,£125.00,1,GST,,0,1,0,0,0,0,0,125,500,500,500,500,500,0,0,0,0,0,0,0,0,0,0,0,0,0,0,0,0,0,0,0,0,0,0,0,0,N,,,
IC004,Calibration-Tortus,,S,,,43003,,,,,,,,,,,,,,,,,£650.00,1,GST,,0,1,0,0,0,0,0,650,125,125,125,125,125,0,0,0,0,0,0,0,0,0,0,0,0,0,0,0,0,0,0,0,0,0,0,0,0,N,,,
IC005,Control Testing-Tortus,,S,,,43003,,,,,,,,,,,,,,,,,£500.00,1,GST,,0,1,0,0,0,0,0,500,600,600,600,600,600,0,0,0,0,0,0,0,0,0,0,0,0,0,0,0,0,0,0,0,0,0,0,0,0,N,,,
IT001,Int Train- Pendulum (AS 4663),,S,,,43003,,,,,,,,,,,,,,,,,"£1,995.00",1,GST,,0,1,0,0,0,0,0,1995,500,500,500,500,500,0,0,0,0,0,0,0,0,0,0,0,0,0,0,0,0,0,0,0,0,0,0,0,0,N,,,
IT002,Int Train-Pendulum(AS/NZ 4663),,S,,,43003,,,,,,,,,,,,,,,,,"£1,995.00",1,GST,,0,1,0,0,0,0,0,1995,1995,1995,1995,1995,1995,0,0,0,0,0,0,0,0,0,0,0,0,0,0,0,0,0,0,0,0,0,0,0,0,N,,,
IT003,Int Train-Pendulum(SS 485),,S,,,43003,,,,,,,,,,,,,,,,,"£1,995.00",1,GST,,0,1,0,0,0,0,0,1995,1995,1995,1995,1995,1995,0,0,0,0,0,0,0,0,0,0,0,0,0,0,0,0,0,0,0,0,0,0,0,0,N,,,
IT004,Int Train-Pendulum(BS 7976),,S,,,43003,,,,,,,,,,,,,,,,,"£1,995.00",1,GST,,0,1,0,0,0,0,0,1995,1995,1995,1995,1995,1995,0,0,0,0,0,0,0,0,0,0,0,0,0,0,0,0,0,0,0,0,0,0,0,0,N,,,
IT005,Int Train-Pend(CEN/TS 16165),,S,,,43003,,,,,,,,,,,,,,,,,"£1,995.00",1,GST,,0,1,0,0,0,0,0,1995,1995,1995,1995,1995,1995,0,0,0,0,0,0,0,0,0,0,0,0,0,0,0,0,0,0,0,0,0,0,0,0,N,,,
IT006,Int Train-Pend (ASTM E303),,S,,,43003,,,,,,,,,,,,,,,,,"£1,995.00",1,GST,,0,1,0,0,0,0,0,1995,1995,1995,1995,1995,1995,0,0,0,0,0,0,0,0,0,0,0,0,0,0,0,0,0,0,0,0,0,0,0,0,N,,,
IT007,Int Train-Pend (GB/T 31153),,S,,,43003,,,,,,,,,,,,,,,,,"£1,995.00",1,GST,,0,1,0,0,0,0,0,1995,1995,1995,1995,1995,1995,0,0,0,0,0,0,0,0,0,0,0,0,0,0,0,0,0,0,0,0,0,0,0,0,N,,,
IT008,Int Train Pend Verificat/Maint,,S,,,43003,,,,,,,,,,,,,,,,,£995.00,1,GST,,0,1,0,0,0,0,0,995,1995,1995,1995,1995,1995,0,0,0,0,0,0,0,0,0,0,0,0,0,0,0,0,0,0,0,0,0,0,0,0,N,,,
IT009,Pend Calib Procedure (Doc Only,,S,,,43003,,,,,,,,,,,,,,,,,"£4,995.00",1,GST,,0,1,0,0,0,0,0,4995,995,995,995,995,995,0,0,0,0,0,0,0,0,0,0,0,0,0,0,0,0,0,0,0,0,0,0,0,0,N,,,
IT010,Int Train-Pend Calib (BS 7976),,S,,,43003,,,,,,,,,,,,,,,,,"£4,995.00",1,GST,,0,1,0,0,0,0,0,4995,4995,4995,4995,4995,4995,0,0,0,0,0,0,0,0,0,0,0,0,0,0,0,0,0,0,0,0,0,0,0,0,N,,,
IT011,Int Train- Tortus (AS4663),,S,,,43003,,,,,,,,,,,,,,,,,£995.00,1,GST,,0,1,0,0,0,0,0,995,4995,4995,4995,4995,4995,0,0,0,0,0,0,0,0,0,0,0,0,0,0,0,0,0,0,0,0,0,0,0,0,N,,,
IT012,Int Train-Tortus (AS/NZ 4663),,S,,,43003,,,,,,,,,,,,,,,,,£995.00,1,GST,,0,1,0,0,0,0,0,995,995,995,995,995,995,0,0,0,0,0,0,0,0,0,0,0,0,0,0,0,0,0,0,0,0,0,0,0,0,N,,,
IT013,Int Train- Tortus (SS 485),,S,,,43003,,,,,,,,,,,,,,,,,£995.00,1,GST,,0,1,0,0,0,0,0,995,995,995,995,995,995,0,0,0,0,0,0,0,0,0,0,0,0,0,0,0,0,0,0,0,0,0,0,0,0,N,,,
IT014,Tortus Verification/Maintenanc,,S,,,43003,,,,,,,,,,,,,,,,,£995.00,1,GST,,0,1,0,0,0,0,0,995,995,995,995,995,995,0,0,0,0,0,0,0,0,0,0,0,0,0,0,0,0,0,0,0,0,0,0,0,0,N,,,
SF001,Pick Up from ISTS HQ,,S,,,43003,,,,,,,,,,,,,,,,,£0.00,1,GST,,0,1,0,0,0,0,0,0,995,995,995,995,995,0,0,0,0,0,0,0,0,0,0,0,0,0,0,0,0,0,0,0,0,0,0,0,0,N,,,
SF002,Shipping Fee S1,,S,,,43003,,,,,,,,,,,,,,,,,£25.00,1,GST,,0,1,0,0,0,0,0,25,25,25,25,25,25,0,0,0,0,0,0,0,0,0,0,0,0,0,0,0,0,0,0,0,0,0,0,0,0,N,,,
SF003,Shipping Fee S2,,S,,,43003,,,,,,,,,,,,,,,,,£50.00,1,GST,,0,1,0,0,0,0,0,50,25,25,25,25,25,0,0,0,0,0,0,0,0,0,0,0,0,0,0,0,0,0,0,0,0,0,0,0,0,N,,,
SF004,Shipping Fee S3,,S,,,43003,,,,,,,,,,,,,,,,,£75.00,1,GST,,0,1,0,0,0,0,0,75,50,50,50,50,50,0,0,0,0,0,0,0,0,0,0,0,0,0,0,0,0,0,0,0,0,0,0,0,0,N,,,
SF005,Shipping Fee S4,,S,,,43003,,,,,,,,,,,,,,,,,£100.00,1,GST,,0,1,0,0,0,0,0,100,75,75,75,75,75,0,0,0,0,0,0,0,0,0,0,0,0,0,0,0,0,0,0,0,0,0,0,0,0,N,,,
SF006,Shipping Fee S5,,S,,,43003,,,,,,,,,,,,,,,,,£125.00,1,GST,,0,1,0,0,0,0,0,125,100,100,100,100,100,0,0,0,0,0,0,0,0,0,0,0,0,0,0,0,0,0,0,0,0,0,0,0,0,N,,,
SF007,Shipping Fee S6,,S,,,43003,,,,,,,,,,,,,,,,,£150.00,1,GST,,0,1,0,0,0,0,0,150,125,125,125,125,125,0,0,0,0,0,0,0,0,0,0,0,0,0,0,0,0,0,0,0,0,0,0,0,0,N,,,
SF008,Shipping Fee S7,,S,,,43003,,,,,,,,,,,,,,,,,£175.00,1,GST,,0,1,0,0,0,0,0,175,150,150,150,150,150,0,0,0,0,0,0,0,0,0,0,0,0,0,0,0,0,0,0,0,0,0,0,0,0,N,,,
SF009,Shipping Fee S8,,S,,,43003,,,,,,,,,,,,,,,,,£200.00,1,GST,,0,1,0,0,0,0,0,200,175,175,175,175,175,0,0,0,0,0,0,0,0,0,0,0,0,0,0,0,0,0,0,0,0,0,0,0,0,N,,,
SF010,Shipping Fee S9,,S,,,43003,,,,,,,,,,,,,,,,,£225.00,1,GST,,0,1,0,0,0,0,0,225,200,200,200,200,200,0,0,0,0,0,0,0,0,0,0,0,0,0,0,0,0,0,0,0,0,0,0,0,0,N,,,
SF011,Shipping Fee S10,,S,,,43003,,,,,,,,,,,,,,,,,£250.00,1,GST,,0,1,0,0,0,0,0,250,225,225,225,225,225,0,0,0,0,0,0,0,0,0,0,0,0,0,0,0,0,0,0,0,0,0,0,0,0,N,,,
SF012,Shipping Fee S11,,S,,,43003,,,,,,,,,,,,,,,,,£275.00,1,GST,,0,1,0,0,0,0,0,275,250,250,250,250,250,0,0,0,0,0,0,0,0,0,0,0,0,0,0,0,0,0,0,0,0,0,0,0,0,N,,,
SF013,Shipping Fee S12,,S,,,43003,,,,,,,,,,,,,,,,,£300.00,1,GST,,0,1,0,0,0,0,0,300,275,275,275,275,275,0,0,0,0,0,0,0,0,0,0,0,0,0,0,0,0,0,0,0,0,0,0,0,0,N,,,
SF014,Shipping Fee S13,,S,,,43003,,,,,,,,,,,,,,,,,£325.00,1,GST,,0,1,0,0,0,0,0,325,300,300,300,300,300,0,0,0,0,0,0,0,0,0,0,0,0,0,0,0,0,0,0,0,0,0,0,0,0,N,,,
SF015,Shipping Fee S14,,S,,,43003,,,,,,,,,,,,,,,,,£350.00,1,GST,,0,1,0,0,0,0,0,350,325,325,325,325,325,0,0,0,0,0,0,0,0,0,0,0,0,0,0,0,0,0,0,0,0,0,0,0,0,N,,,
SF016,Shipping Fee S15,,S,,,43003,,,,,,,,,,,,,,,,,£375.00,1,GST,,0,1,0,0,0,0,0,375,350,350,350,350,350,0,0,0,0,0,0,0,0,0,0,0,0,0,0,0,0,0,0,0,0,0,0,0,0,N,,,
SF017,Shipping Fee S16,,S,,,43003,,,,,,,,,,,,,,,,,£400.00,1,GST,,0,1,0,0,0,0,0,400,375,375,375,375,375,0,0,0,0,0,0,0,0,0,0,0,0,0,0,0,0,0,0,0,0,0,0,0,0,N,,,
SF018,Shipping Fee S17,,S,,,43003,,,,,,,,,,,,,,,,,£425.00,1,GST,,0,1,0,0,0,0,0,425,400,400,400,400,400,0,0,0,0,0,0,0,0,0,0,0,0,0,0,0,0,0,0,0,0,0,0,0,0,N,,,
SF019,Shipping Fee S18,,S,,,43003,,,,,,,,,,,,,,,,,£450.00,1,GST,,0,1,0,0,0,0,0,450,425,425,425,425,425,0,0,0,0,0,0,0,0,0,0,0,0,0,0,0,0,0,0,0,0,0,0,0,0,N,,,
SF020,Shipping Fee S19,,S,,,43003,,,,,,,,,,,,,,,,,£475.00,1,GST,,0,1,0,0,0,0,0,475,450,450,450,450,450,0,0,0,0,0,0,0,0,0,0,0,0,0,0,0,0,0,0,0,0,0,0,0,0,N,,,
SF021,Shipping Fee S20,,S,,,43003,,,,,,,,,,,,,,,,,£500.00,1,GST,,0,1,0,0,0,0,0,500,475,475,475,475,475,0,0,0,0,0,0,0,0,0,0,0,0,0,0,0,0,0,0,0,0,0,0,0,0,N,,,
SF022,Shipping Fee S21,,S,,,43003,,,,,,,,,,,,,,,,,£550.00,1,GST,,0,1,0,0,0,0,0,550,500,500,500,500,500,0,0,0,0,0,0,0,0,0,0,0,0,0,0,0,0,0,0,0,0,0,0,0,0,N,,,
SF023,Shipping Fee S22,,S,,,43003,,,,,,,,,,,,,,,,,£600.00,1,GST,,0,1,0,0,0,0,0,600,550,550,550,550,550,0,0,0,0,0,0,0,0,0,0,0,0,0,0,0,0,0,0,0,0,0,0,0,0,N,,,
SF024,Shipping Fee S23,,S,,,43003,,,,,,,,,,,,,,,,,£650.00,1,GST,,0,1,0,0,0,0,0,650,600,600,600,600,600,0,0,0,0,0,0,0,0,0,0,0,0,0,0,0,0,0,0,0,0,0,0,0,0,N,,,
SF025,Shipping Fee S24,,S,,,43003,,,,,,,,,,,,,,,,,£700.00,1,GST,,0,1,0,0,0,0,0,700,650,650,650,650,650,0,0,0,0,0,0,0,0,0,0,0,0,0,0,0,0,0,0,0,0,0,0,0,0,N,,,
SF026,Shipping Fee S25,,S,,,43003,,,,,,,,,,,,,,,,,£750.00,1,GST,,0,1,0,0,0,0,0,750,700,700,700,700,700,0,0,0,0,0,0,0,0,0,0,0,0,0,0,0,0,0,0,0,0,0,0,0,0,N,,,
SF027,Shipping Fee S26,,S,,,43003,,,,,,,,,,,,,,,,,£800.00,1,GST,,0,1,0,0,0,0,0,800,750,750,750,750,750,0,0,0,0,0,0,0,0,0,0,0,0,0,0,0,0,0,0,0,0,0,0,0,0,N,,,
SF028,Shipping Fee S27,,S,,,43003,,,,,,,,,,,,,,,,,£850.00,1,GST,,0,1,0,0,0,0,0,850,800,800,800,800,800,0,0,0,0,0,0,0,0,0,0,0,0,0,0,0,0,0,0,0,0,0,0,0,0,N,,,
SF029,Shipping Fee S28,,S,,,43003,,,,,,,,,,,,,,,,,£900.00,1,GST,,0,1,0,0,0,0,0,900,850,850,850,850,850,0,0,0,0,0,0,0,0,0,0,0,0,0,0,0,0,0,0,0,0,0,0,0,0,N,,,
SF030,Shipping Fee S29,,S,,,43003,,,,,,,,,,,,,,,,,£950.00,1,GST,,0,1,0,0,0,0,0,950,900,900,900,900,900,0,0,0,0,0,0,0,0,0,0,0,0,0,0,0,0,0,0,0,0,0,0,0,0,N,,,
SF031,Shipping Fee S30,,S,,,43003,,,,,,,,,,,,,,,,,"£1,000.00",1,GST,,0,1,0,0,0,0,0,1000,950,950,950,950,950,0,0,0,0,0,0,0,0,0,0,0,0,0,0,0,0,0,0,0,0,0,0,0,0,N,,,
SF032,Shipping Fee S31,,S,,,43003,,,,,,,,,,,,,,,,,"£1,050.00",1,GST,,0,1,0,0,0,0,0,1050,1000,1000,1000,1000,1000,0,0,0,0,0,0,0,0,0,0,0,0,0,0,0,0,0,0,0,0,0,0,0,0,N,,,
SF033,Shipping Fee S32,,S,,,43003,,,,,,,,,,,,,,,,,"£1,100.00",1,GST,,0,1,0,0,0,0,0,1100,1050,1050,1050,1050,1050,0,0,0,0,0,0,0,0,0,0,0,0,0,0,0,0,0,0,0,0,0,0,0,0,N,,,
SF034,Shipping Fee S33,,S,,,43003,,,,,,,,,,,,,,,,,"£1,150.00",1,GST,,0,1,0,0,0,0,0,1150,1100,1100,1100,1100,1100,0,0,0,0,0,0,0,0,0,0,0,0,0,0,0,0,0,0,0,0,0,0,0,0,N,,,
SF035,Shipping Fee S34,,S,,,43003,,,,,,,,,,,,,,,,,"£1,200.00",1,GST,,0,1,0,0,0,0,0,1200,11150,11150,11150,11150,11150,0,0,0,0,0,0,0,0,0,0,0,0,0,0,0,0,0,0,0,0,0,0,0,0,N,,,
SF036,Shipping Fee S35,,S,,,43003,,,,,,,,,,,,,,,,,"£1,250.00",1,GST,,0,1,0,0,0,0,0,1250,1150,1150,1150,1150,1150,0,0,0,0,0,0,0,0,0,0,0,0,0,0,0,0,0,0,0,0,0,0,0,0,N,,,
SF037,Shipping Fee S36,,S,,,43003,,,,,,,,,,,,,,,,,"£1,300.00",1,GST,,0,1,0,0,0,0,0,1300,1250,1250,1250,1250,1250,0,0,0,0,0,0,0,0,0,0,0,0,0,0,0,0,0,0,0,0,0,0,0,0,N,,,
SF038,Shipping Fee S37,,S,,,43003,,,,,,,,,,,,,,,,,"£1,350.00",1,GST,,0,1,0,0,0,0,0,1350,1300,1300,1300,1300,1300,0,0,0,0,0,0,0,0,0,0,0,0,0,0,0,0,0,0,0,0,0,0,0,0,N,,,
SF039,Shipping Fee S38,,S,,,43003,,,,,,,,,,,,,,,,,"£1,400.00",1,GST,,0,1,0,0,0,0,0,1400,1350,1350,1350,1350,1350,0,0,0,0,0,0,0,0,0,0,0,0,0,0,0,0,0,0,0,0,0,0,0,0,N,,,
SF040,Shipping Fee S39,,S,,,43003,,,,,,,,,,,,,,,,,"£1,450.00",1,GST,,0,1,0,0,0,0,0,1450,1400,1400,1400,1400,1400,0,0,0,0,0,0,0,0,0,0,0,0,0,0,0,0,0,0,0,0,0,0,0,0,N,,,
SF041,Shipping Fee S40,,S,,,43003,,,,,,,,,,,,,,,,,"£1,500.00",1,GST,,0,1,0,0,0,0,0,1500,1450,1450,1450,1450,1450,0,0,0,0,0,0,0,0,0,0,0,0,0,0,0,0,0,0,0,0,0,0,0,0,N,,,
SF042,Shipping Fee S41,,S,,,43003,,,,,,,,,,,,,,,,,"£1,550.00",1,GST,,0,1,0,0,0,0,0,1550,1500,1500,1500,1500,1500,0,0,0,0,0,0,0,0,0,0,0,0,0,0,0,0,0,0,0,0,0,0,0,0,N,,,
SF043,Shipping Fee S42,,S,,,43003,,,,,,,,,,,,,,,,,"£1,600.00",1,GST,,0,1,0,0,0,0,0,1600,1550,1550,1550,1550,1550,0,0,0,0,0,0,0,0,0,0,0,0,0,0,0,0,0,0,0,0,0,0,0,0,N,,,
SF044,Shipping Fee S43,,S,,,43003,,,,,,,,,,,,,,,,,"£1,650.00",1,GST,,0,1,0,0,0,0,0,1650,1600,1600,1600,1600,1600,0,0,0,0,0,0,0,0,0,0,0,0,0,0,0,0,0,0,0,0,0,0,0,0,N,,,
TT001,Training Performed ISTS HQ,,S,,,43003,,,,,,,,,,,,,,,,,£0.00,1,GST,,0,1,0,0,0,0,0,0,1650,1650,1650,1650,1650,0,0,0,0,0,0,0,0,0,0,0,0,0,0,0,0,0,0,0,0,0,0,0,0,N,,,
TT002,Training Travel Fee T1,,S,,,43003,,,,,,,,,,,,,,,,,£500.00,1,GST,,0,1,0,0,0,0,0,500,500,500,500,500,500,0,0,0,0,0,0,0,0,0,0,0,0,0,0,0,0,0,0,0,0,0,0,0,0,N,,,
TT003,Training Travel Fee T2,,S,,,43003,,,,,,,,,,,,,,,,,£750.00,1,GST,,0,1,0,0,0,0,0,750,500,500,500,500,500,0,0,0,0,0,0,0,0,0,0,0,0,0,0,0,0,0,0,0,0,0,0,0,0,N,,,
TT004,Training Travel Fee T3,,S,,,43003,,,,,,,,,,,,,,,,,"£1,000.00",1,GST,,0,1,0,0,0,0,0,1000,750,750,750,750,750,0,0,0,0,0,0,0,0,0,0,0,0,0,0,0,0,0,0,0,0,0,0,0,0,N,,,
TT005,Training Travel Fee T4,,S,,,43003,,,,,,,,,,,,,,,,,"£1,250.00",1,GST,,0,1,0,0,0,0,0,1250,1000,1000,1000,1000,1000,0,0,0,0,0,0,0,0,0,0,0,0,0,0,0,0,0,0,0,0,0,0,0,0,N,,,
TT006,Training Travel Fee T5,,S,,,43003,,,,,,,,,,,,,,,,,"£1,500.00",1,GST,,0,1,0,0,0,0,0,1500,1250,1250,1250,1250,1250,0,0,0,0,0,0,0,0,0,0,0,0,0,0,0,0,0,0,0,0,0,0,0,0,N,,,
TT007,Training Travel Fee T6,,S,,,43003,,,,,,,,,,,,,,,,,"£1,750.00",1,GST,,0,1,0,0,0,0,0,1750,1500,1500,1500,1500,1500,0,0,0,0,0,0,0,0,0,0,0,0,0,0,0,0,0,0,0,0,0,0,0,0,N,,,
TT008,Training Travel Fee T7,,S,,,43003,,,,,,,,,,,,,,,,,"£2,000.00",1,GST,,0,1,0,0,0,0,0,2000,1750,1750,1750,1750,1750,0,0,0,0,0,0,0,0,0,0,0,0,0,0,0,0,0,0,0,0,0,0,0,0,N,,,
TT009,Training Travel Fee T8,,S,,,43003,,,,,,,,,,,,,,,,,"£2,250.00",1,GST,,0,1,0,0,0,0,0,2250,2000,2000,2000,2000,2000,0,0,0,0,0,0,0,0,0,0,0,0,0,0,0,0,0,0,0,0,0,0,0,0,N,,,
TT010,Training Travel Fee T9,,S,,,43003,,,,,,,,,,,,,,,,,"£2,500.00",1,GST,,0,1,0,0,0,0,0,2500,2250,2250,2250,2250,2250,0,0,0,0,0,0,0,0,0,0,0,0,0,0,0,0,0,0,0,0,0,0,0,0,N,,,
TT011,Training Travel Fee T10,,S,,,43003,,,,,,,,,,,,,,,,,"£2,750.00",1,GST,,0,1,0,0,0,0,0,2750,2500,2500,2500,2500,2500,0,0,0,0,0,0,0,0,0,0,0,0,0,0,0,0,0,0,0,0,0,0,0,0,N,,,
TT012,Training Travel Fee T11,,S,,,43003,,,,,,,,,,,,,,,,,"£3,000.00",1,GST,,0,1,0,0,0,0,0,3000,2750,2750,2750,2750,2750,0,0,0,0,0,0,0,0,0,0,0,0,0,0,0,0,0,0,0,0,0,0,0,0,N,,,
TT013,Training Travel Fee T12,,S,,,43003,,,,,,,,,,,,,,,,,"£3,250.00",1,GST,,0,1,0,0,0,0,0,3250,3000,3000,3000,3000,3000,0,0,0,0,0,0,0,0,0,0,0,0,0,0,0,0,0,0,0,0,0,0,0,0,N,,,
TT014,Training Travel Fee T13,,S,,,43003,,,,,,,,,,,,,,,,,"£3,500.00",1,GST,,0,1,0,0,0,0,0,3500,3250,3250,3250,3250,3250,0,0,0,0,0,0,0,0,0,0,0,0,0,0,0,0,0,0,0,0,0,0,0,0,N,,,
TT015,Training Travel Fee T14,,S,,,43003,,,,,,,,,,,,,,,,,"£3,750.00",1,GST,,0,1,0,0,0,0,0,3750,3500,3500,3500,3500,3500,0,0,0,0,0,0,0,0,0,0,0,0,0,0,0,0,0,0,0,0,0,0,0,0,N,,,
TT016,Training Travel Fee T15,,S,,,43003,,,,,,,,,,,,,,,,,"£4,000.00",1,GST,,0,1,0,0,0,0,0,4000,3750,3750,3750,3750,3750,0,0,0,0,0,0,0,0,0,0,0,0,0,0,0,0,0,0,0,0,0,0,0,0,N,,,
TT017,Training Travel Fee T16,,S,,,43003,,,,,,,,,,,,,,,,,"£4,250.00",1,GST,,0,1,0,0,0,0,0,4250,4000,4000,4000,4000,4000,0,0,0,0,0,0,0,0,0,0,0,0,0,0,0,0,0,0,0,0,0,0,0,0,N,,,
T0018,Training Travel Fee T17,,S,,,43003,,,,,,,,,,,,,,,,,"£4,500.00",1,GST,,0,1,0,0,0,0,0,4500,4250,4250,4250,4250,4250,0,0,0,0,0,0,0,0,0,0,0,0,0,0,0,0,0,0,0,0,0,0,0,0,N,,,
TT018,Training Travel Fee T17,,S,,,43003,,,,,,,,,,,,,,,,,"£4,500.00",1,GST,,0,1,0,0,0,0,0,4500,4500,4500,4500,4500,4500,0,0,0,0,0,0,0,0,0,0,0,0,0,0,0,0,0,0,0,0,0,0,0,0,N,,,
TT019,Training Travel Fee T18,,S,,,43003,,,,,,,,,,,,,,,,,"£4,750.00",1,GST,,0,1,0,0,0,0,0,4750,4750,4750,4750,4750,4750,0,0,0,0,0,0,0,0,0,0,0,0,0,0,0,0,0,0,0,0,0,0,0,0,N,,,
TT020,Training Travel Fee T19,,S,,,43003,,,,,,,,,,,,,,,,,"£5,000.00",1,GST,,0,1,0,0,0,0,0,5000,4750,4750,4750,4750,4750,0,0,0,0,0,0,0,0,0,0,0,0,0,0,0,0,0,0,0,0,0,0,0,0,N,,,
TT021,Training Travel Fee T20,,S,,,43003,,,,,,,,,,,,,,,,,"£5,250.00",1,GST,,0,1,0,0,0,0,0,5250,5000,5000,5000,5000,5000,0,0,0,0,0,0,0,0,0,0,0,0,0,0,0,0,0,0,0,0,0,0,0,0,N,,,
TT022,Training Travel Fee T21,,S,,,43003,,,,,,,,,,,,,,,,,"£5,500.00",1,GST,,0,1,0,0,0,0,0,5500,5000,5000,5000,5000,5000,0,0,0,0,0,0,0,0,0,0,0,0,0,0,0,0,0,0,0,0,0,0,0,0,N,,,
TT023,Training Travel Fee T22,,S,,,43003,,,,,,,,,,,,,,,,,"£5,750.00",1,GST,,0,1,0,0,0,0,0,5750,5500,5500,5500,5500,5500,0,0,0,0,0,0,0,0,0,0,0,0,0,0,0,0,0,0,0,0,0,0,0,0,N,,,
TT024,Training Travel Fee T23,,S,,,43003,,,,,,,,,,,,,,,,,"£6,000.00",1,GST,,0,1,0,0,0,0,0,6000,5750,5750,5750,5750,5750,0,0,0,0,0,0,0,0,0,0,0,0,0,0,0,0,0,0,0,0,0,0,0,0,N,,,
TT025,Training Travel Fee T24,,S,,,43003,,,,,,,,,,,,,,,,,"£6,250.00",1,GST,,0,1,0,0,0,0,0,6250,6000,6000,6000,6000,6000,0,0,0,0,0,0,0,0,0,0,0,0,0,0,0,0,0,0,0,0,0,0,0,0,N,,,
TT026,Training Travel Fee T25,,S,,,43003,,,,,,,,,,,,,,,,,"£6,500.00",1,GST,,0,1,0,0,0,0,0,6500,6250,6250,6250,6250,6250,0,0,0,0,0,0,0,0,0,0,0,0,0,0,0,0,0,0,0,0,0,0,0,0,N,,,
WL051,WammaLab Pendulum Tool Case,B,S,I,11201,43003,50001,,,,,,,,,,,N-T,,1,0,0,£45.00,,GST,,0,1,0,0,0,0,0,45,45,45,45,45,45,0,0,0,0,0,0,0,0,0,0,0,0,0,0,0,0,0,0,0,0,0,0,0,0,N,£0.00,,
WL052,WammaLab Pend Flt Case Wheel,B,S,I,11201,43003,50001,,,,,,,,,,,N-T,,1,0,0,£120.00,,GST,,0,1,0,0,0,0,0,120,120,120,120,120,120,0,0,0,0,0,0,0,0,0,0,0,0,0,0,0,0,0,0,0,0,0,0,0,0,N,£15.58,,
WS035,Wessex Tortus 3 Motherboard,B,S,I,11201,43003,50001,,,,,,,,,,,GST,,1,0,0,£0.00,,GST,,0,1,0,0,0,0,0,0,0,0,0,0,0,0,0,0,0,0,0,0,0,0,0,0,0,0,0,0,0,0,0,0,0,0,0,0,0,Y,£0.00,,
TC013,Double Sided Tape-Control Test,B,S,I,11201,43003,50001,,,,,,,,,,,GST,,1,0,0,£0.00,,GST,,0,1,0,0,0,0,0,0,0,0,0,0,0,0,0,0,0,0,0,0,0,0,0,0,0,0,0,0,0,0,0,0,0,0,0,0,0,N,£0.00,,
WL053,WammaLab Pend Centre Spindle,B,S,I,11201,43003,50001,,,,,,,,,,,N-T,,1,0,0,£0.00,,GST,,0,1,0,0,0,0,0,0,0,0,0,0,0,0,0,0,0,0,0,0,0,0,0,0,0,0,0,0,0,0,0,0,0,0,0,0,0,N,£153.00,,
WL054,WammaLab Pen Foot Bearing Wash,B,S,I,11201,43003,50001,,,,,,,,,,,N-T,,1,0,0,£20.00,,GST,,0,1,0,0,0,0,0,20,20,20,20,20,20,0,0,0,0,0,0,0,0,0,0,0,0,0,0,0,0,0,0,0,0,0,0,0,0,N,£0.00,,
WL055,WammaLab Pend Foot Bearing Nut,B,S,I,11201,43003,50001,,,,,,,,,,,N-T,,1,0,0,£9.00,,GST,,0,1,0,0,0,0,0,9,9,9,9,9,9,0,0,0,0,0,0,0,0,0,0,0,0,0,0,0,0,0,0,0,0,0,0,0,0,N,£0.00,,
WL056,WammaLab Pendulum Foot Rocker ,B,S,I,11201,43003,50001,,,,,,,,,,,N-T,,1,0,0,£20.00,,GST,,0,1,0,0,0,0,0,20,20,20,20,20,20,0,0,0,0,0,0,0,0,0,0,0,0,0,0,0,0,0,0,0,0,0,0,0,0,N,£7.20,,
WL057,WammaLab Pendulum Foot Rkr Pin,B,S,I,11201,43003,50001,,,,,,,,,,,N-T,,1,0,0,£4.00,,GST,,0,1,0,0,0,0,0,4,4,4,4,4,4,0,0,0,0,0,0,0,0,0,0,0,0,0,0,0,0,0,0,0,0,0,0,0,0,N,£0.23,,
WL058,WammaLab Lifting Arm Cover Pla,B,S,,,43003,50001,,,,,,,,,,,N-T,,,0,,£64.00,,GST,,0,1,0,0,0,0,0,64,64,64,64,64,64,0,0,0,0,0,0,0,0,0,0,0,0,0,0,0,0,0,0,0,0,0,0,0,0,N,£0.00,,
WL059,WammaLab Pendulum 17 Spanner,B,S,I,11201,43003,50001,,,,,,,,,,,N-T,,1,0,0,£25.00,,GST,,0,1,0,0,0,0,0,25,25,25,25,25,25,0,0,0,0,0,0,0,0,0,0,0,0,0,0,0,0,0,0,0,0,0,0,0,0,N,£0.00,,
WL060,WammaLab Pendul Spndle Fnt Nut,B,S,I,11201,43003,50001,,,,,,,,,,,N-T,,1,0,0,£25.00,,GST,,0,1,0,0,0,0,0,25,25,25,25,25,25,0,0,0,0,0,0,0,0,0,0,0,0,0,0,0,0,0,0,0,0,0,0,0,0,N,£0.00,,
WL061,WammaLab Pendulum Leg Fix Knob,B,S,I,11201,43003,50001,,,,,,,,,,,N-T,,1,0,0,£29.00,,GST,,0,1,0,0,0,0,0,29,29,29,29,29,29,0,0,0,0,0,0,0,0,0,0,0,0,0,0,0,0,0,0,0,0,0,0,0,0,N,£9.80,,
WSX006,Wessex Tortus USB Stick,B,S,I,11201,43003,50001,,,,,,,,,QM Systems Ltd,,N-T,,1,0,0,£180.00,1,GST,,0,1,0,0,0,0,0,180,180,180,180,180,180,0,0,0,0,0,0,0,0,0,0,0,0,0,0,0,0,0,0,0,0,0,0,0,0,N,£0.00,,
TC014,Tortus Thermal Paper Roll,B,S,I,11201,43003,50001,,,,,,,,,,,GST,,1,0,0,£11.50,,GST,,0,1,0,0,0,0,0,11.5,11.5,11.5,11.5,11.5,11.5,0,0,0,0,0,0,0,0,0,0,0,0,0,0,0,0,0,0,0,0,0,0,0,0,N,£3.00,,
IC 006,Post Repair Instrument Recalib,,S,,,43003,,,,,,,,,,,,,,,,,£525.00,,GST,,0,1,0,0,0,0,0,525,525,525,525,525,525,0,0,0,0,0,0,0,0,0,0,0,0,0,0,0,0,0,0,0,0,0,0,0,0,N,,,
IC006,Post Repair Instrument Recalib,,S,,,43003,,,,,,,,,,,,,,,,,£525.00,,GST,,0,1,0,0,0,0,0,525,525,525,525,525,525,0,0,0,0,0,0,0,0,0,0,0,0,0,0,0,0,0,0,0,0,0,0,0,0,N,,,
WL062,WanmaLab Pendulum  Swap,B,S,I,11201,43003,50001,,,,,,,,,,,N-T,,1,0,0,£345.00,,GST,,0,1,0,0,0,0,0,345,345,345,345,345,345,0,0,0,0,0,0,0,0,0,0,0,0,0,0,0,0,0,0,0,0,0,0,0,0,N,£0.00,,
